goodly	positive
revile	negative
irritation	negative
stupendously	positive
lividly	negative
diligence	positive
aver	positive
restless	negative
alluring	positive
brainy	positive
over-awe	negative
bruising	negative
hapless	negative
apprehensive	negative
scolding	negative
manipulative	negative
unlimited	positive
oddest	negative
desolate	negative
offend	negative
scarcely	negative
agonizing	negative
appreciatively	positive
insensible	negative
foulness	negative
prison	negative
fundamentalism	negative
itching	negative
exagerates	negative
feature-rich	positive
feasibly	positive
uncompetitive	negative
survivor	positive
slime	negative
well-managed	positive
defamation	negative
greedy	negative
pollute	negative
bullshit	negative
peppy	positive
murderer	negative
barbarously	negative
abomination	negative
tangles	negative
portable	positive
languish	negative
grievously	negative
superficially	negative
scowl	negative
neatest	positive
mysteriously	negative
headway	positive
selfishly	negative
inefficient	negative
womanizing	negative
noisy	negative
debauchery	negative
vexing	negative
antithetical	negative
traduce	negative
incompetence	negative
risky	negative
impartially	positive
downturn	negative
glower	negative
dependable	positive
stupid	negative
likable	positive
impertinent	negative
heartwarming	positive
siege	negative
meanness	negative
powerfully	positive
smiling	positive
remorselessly	negative
crashes	negative
astounding	positive
hardier	positive
unwise	negative
irrepressible	negative
sluts	negative
throb	negative
successes	positive
irritating	negative
vain	negative
backbiting	negative
priceless	positive
rejuvenate	positive
hardliner	negative
criticism	negative
radical	negative
propitiously	positive
aggressor	negative
forebodingly	negative
award	positive
popular	positive
full-blown	negative
renowned	positive
jerk	negative
effrontery	negative
dizzing	negative
distracting	negative
taunt	negative
woo	positive
scrambling	negative
complaint	negative
jarring	negative
madly	negative
debt	negative
stiflingly	negative
sporadic	negative
brusque	negative
squeak	negative
annoys	negative
complaints	negative
brashness	negative
menacing	negative
diatribes	negative
jobless	negative
zenith	positive
bland	negative
inequitably	negative
thumbs-up	positive
gumption	positive
inconvenience	negative
cruelness	negative
fanatically	negative
dismal	negative
insulted	negative
commodious	positive
instantly	positive
incessant	negative
retarded	negative
unattractive	negative
brutalities	negative
self-defeating	negative
funnily	negative
fat-cat	negative
devilishly	negative
deadbeat	negative
predatory	negative
streamlined	positive
upscale	positive
restored	positive
limit	negative
thankless	negative
promise	positive
cannibal	negative
ill-usage	negative
irragularity	negative
invalidate	negative
misrepresent	negative
mispronounces	negative
harried	negative
corruption	negative
nonsense	negative
insufficiently	negative
unfounded	negative
extort	negative
first-class	positive
eminence	positive
courageously	positive
frantically	negative
listless	negative
broken	negative
inequities	negative
cruelly	negative
brazen	negative
evaluative	positive
kindness	positive
denigrate	negative
wretch	negative
shiny	positive
delirious	negative
murder	negative
buoyant	positive
asinininity	negative
misguide	negative
master	positive
glib	negative
malevolent	negative
nicely	positive
cute	positive
intrusion	negative
menacingly	negative
heck	negative
slooow	negative
levity	positive
unsure	negative
low-priced	positive
astonishment	positive
ironic	negative
haunt	negative
slack	negative
lone	negative
elegantly	positive
loot	negative
betrayal	negative
uneven	negative
uphold	positive
draconic	negative
dazed	negative
exhilarate	positive
critical	negative
lament	negative
upsetting	negative
pretentiously	negative
enliven	positive
impede	negative
suffice	positive
heavyhearted	negative
indiscreet	negative
pleased	positive
nourish	positive
thankful	positive
unrest	negative
individualized	positive
unreasonable	negative
greatest	positive
despicably	negative
slower	negative
criminal	negative
hated	negative
nurturing	positive
disappointed	negative
spellbindingly	positive
merciful	positive
enjoys	positive
glow	positive
punk	negative
liberty	positive
treason	negative
kill	negative
loathing	negative
stigma	negative
spewed	negative
imaginative	positive
spoils	negative
spoon-fed	negative
hypocrites	negative
sufficiently	positive
trophy	positive
intimacy	positive
rut	negative
hysterical	negative
inteferes	negative
smelly	negative
bleakly	negative
knotted	negative
lethargy	negative
neglect	negative
succeed	positive
irony	negative
imbalance	negative
finer	positive
deceiving	negative
tarnishes	negative
cornerstone	positive
maltreatment	negative
ramshackle	negative
luxuriously	positive
smutty	negative
devastating	negative
exuberance	positive
blah	negative
staunchly	positive
retractable	positive
bug	negative
impudence	negative
absentee	negative
high-spirited	positive
unusual	negative
fervent	positive
dud	negative
dilly-dally	negative
cleverly	positive
craftly	negative
complement	positive
anti-israeli	negative
adequate	positive
traumatize	negative
appealing	positive
aweful	negative
concen	negative
pepping	positive
insignificant	negative
salute	positive
interruptions	negative
sloppily	negative
inculcate	negative
gimmicky	negative
valiant	positive
elan	positive
bearish	negative
beseech	negative
dazzle	positive
booming	positive
irresponsible	negative
encroach	negative
adamant	negative
well-regarded	positive
inactive	negative
louder	negative
strident	negative
endorses	positive
gimmicked	negative
inept	negative
distraught	negative
prate	negative
overstates	negative
infested	negative
opportunistic	negative
steals	negative
excitingly	positive
disruption	negative
blab	negative
unspeakablely	negative
affluence	positive
boring	negative
denying	negative
hate	negative
uninformed	negative
despot	negative
polite	positive
auspicious	positive
chafe	negative
spoil	negative
incompetently	negative
rattled	negative
bother	negative
dump	negative
anxiousness	negative
disappointments	negative
fatigued	negative
unfunded	negative
outshone	positive
frighteningly	negative
fruitless	negative
discompose	negative
instructive	positive
struggling	negative
superb	positive
striving	positive
relaxed	positive
wowing	positive
direly	negative
burned	negative
impetuous	negative
shrivel	negative
downbeat	negative
toughest	positive
firmer	positive
reviled	negative
obstruct	negative
defile	negative
malaise	negative
spite	negative
displeased	negative
overkill	negative
deceitfulness	negative
vex	negative
affirmative	positive
run-down	negative
undocumented	negative
over-priced	negative
ambivalence	negative
disorient	negative
willing	positive
fall	negative
forlornly	negative
worth	positive
wreaked	negative
affirmation	positive
thoughtlessness	negative
ghetto	negative
allergy	negative
amiable	positive
confront	negative
patience	positive
skillful	positive
imbecile	negative
averse	negative
oppressiveness	negative
flabbergasted	negative
incessantly	negative
dope	negative
all-around	positive
overdue	negative
enchanting	positive
secure	positive
negative	negative
stab	negative
modest	positive
remorselessness	negative
notoriously	negative
poisonous	negative
frazzled	negative
peace	positive
impudent	negative
epidemic	negative
resurgent	negative
exultant	positive
upliftment	positive
handier	positive
overshadow	negative
screech	negative
phony	negative
eager	positive
irking	negative
bewilder	negative
wasted	negative
hassle	negative
backward	negative
endearing	positive
shockingly	negative
alarm	negative
warmhearted	positive
top-quality	positive
ebullience	positive
advocates	positive
amazing	positive
harassed	negative
obese	negative
waste	negative
rightful	positive
godsend	positive
honorable	positive
uneasily	negative
unfit	negative
overzelous	negative
freaks	negative
stooge	negative
toll-free	positive
blissful	positive
egotistical	negative
reforms	positive
admiringly	positive
redemption	positive
destroy	negative
anxiety	negative
traumatically	negative
dissolute	negative
fib	negative
easy-to-use	positive
wallow	negative
beneficial	positive
worst	negative
berserk	negative
blemish	negative
dismaying	negative
blockbuster	positive
perverts	negative
timidly	negative
straightforward	positive
mournful	negative
inanely	negative
frighten	negative
wreak	negative
nightmarish	negative
invidiousness	negative
ungovernable	negative
impressively	positive
amazingly	positive
ill-designed	negative
hopeless	negative
clearer	positive
bungler	negative
clears	positive
impractical	negative
dishonorablely	negative
flimsy	negative
hotbeds	negative
wonder	positive
energetic	positive
responsibly	positive
endanger	negative
inhospitable	negative
indecently	negative
shine	positive
falsify	negative
confusion	negative
prickle	negative
approval	positive
quibbles	negative
splendid	positive
occluding	negative
accolades	positive
troubling	negative
exceptionally	positive
moot	negative
starvation	negative
byzantine	negative
enrichment	positive
salutary	positive
languorous	negative
interests	positive
lavish	positive
congestion	negative
apologist	negative
renown	positive
indebted	positive
ill-advised	negative
demolisher	negative
crowded	negative
liked	positive
intimate	positive
inessential	negative
depressingly	negative
disaffirm	negative
intransigence	negative
genius	positive
irrationally	negative
lewdness	negative
inexpertly	negative
obscurity	negative
douchebag	negative
ruins	negative
losers	negative
symptoms	negative
craze	negative
disapointed	negative
savage	negative
headaches	negative
bias	negative
shirker	negative
temptingly	positive
degeneration	negative
treacherous	negative
unprepared	negative
amiabily	positive
positively	positive
dehumanization	negative
irreplaceable	positive
cracks	negative
erudite	positive
irately	negative
desperation	negative
overtake	positive
erratic	negative
restriction	negative
lazy	negative
tempt	positive
simplifies	positive
hotheaded	negative
sumptuously	positive
disappointingly	negative
indeterminate	negative
feat	positive
imaculate	positive
confusing	negative
fatuously	negative
oppose	negative
stymied	negative
luck	positive
improve	positive
rankle	negative
insolvent	negative
writhe	negative
manic	negative
reconcile	positive
perilous	negative
ill-conceived	negative
helplessly	negative
enrage	negative
rock-stars	positive
disgustedly	negative
catastrophically	negative
sh*t	negative
mulish	negative
groundbreaking	positive
bashful	negative
crept	negative
snappy	positive
intricate	positive
tortures	negative
squash	negative
salacious	negative
tantalizingly	positive
well	positive
undecided	negative
oversights	negative
ashamed	negative
devious	negative
fustigate	negative
dilemma	negative
scenic	positive
scoff	negative
lucrative	positive
restlessness	negative
messy	negative
demonizing	negative
bungling	negative
scathing	negative
conciliate	positive
healthful	positive
satisfying	positive
innovative	positive
gall	negative
soothingly	positive
prize	positive
freed	positive
congratulatory	positive
outperforming	positive
demoralizing	negative
inhumane	negative
damnable	negative
fave	positive
indecisive	negative
distinctive	positive
diffidence	negative
stalls	negative
jovial	positive
eccentricity	negative
belittling	negative
ruinous	negative
responsive	positive
tingling	negative
compassionate	positive
insurmountable	negative
inconsiderate	negative
deplore	negative
harmonize	positive
strained	negative
kid-friendly	positive
unresponsive	negative
outrages	negative
maladjustment	negative
bullyingly	negative
razor-sharp	positive
hug	positive
loyalty	positive
vociferous	negative
horde	negative
flexibility	positive
fluent	positive
lackadaisical	negative
denounce	negative
asinine	negative
gawk	negative
plunderer	negative
forlorn	negative
pervert	negative
radicals	negative
stupor	negative
lanky	negative
idiocies	negative
nourishment	positive
angelic	positive
disquietingly	negative
jubilantly	positive
assuredly	positive
cruelties	negative
outmoded	negative
dragged	negative
onerously	negative
viper	negative
itchy	negative
beset	negative
worthless	negative
discontentedly	negative
oversight	negative
doubt	negative
incommensurate	negative
brilliantly	positive
superstition	negative
protested	negative
covenant	positive
decline	negative
radiance	positive
laughingstock	negative
layoff	negative
noisier	negative
oddity	negative
haggle	negative
plague	negative
giddy	negative
bargain	positive
irreparable	negative
wripping	negative
picky	negative
uncivilized	negative
irredeemable	negative
letch	negative
worth-while	positive
beckoning	positive
disappoint	negative
disappointing	negative
wastefulness	negative
steadfast	positive
insouciance	negative
testy	negative
unity	positive
renaissance	positive
clamorous	negative
unethical	negative
retaliate	negative
flairs	negative
beastly	negative
visionary	positive
depression	negative
disrespectablity	negative
importune	negative
denied	negative
ultra-hardline	negative
partisan	negative
unsophisticated	negative
remarkable	positive
jaw-droping	positive
freak	negative
invader	negative
rip	negative
retract	negative
inability	negative
awfulness	negative
unequivocally	positive
cruelest	negative
pittance	negative
darker	negative
proper	positive
ultimatums	negative
refine	positive
rockstar	positive
intefere	negative
sturdy	positive
impresses	positive
imprecate	negative
congenial	positive
inefficiently	negative
intimidation	negative
distraction	negative
fans	positive
fume	negative
imprison	negative
desperately	negative
mistified	negative
inestimable	positive
cozy	positive
blissfully	positive
inevitable	negative
affability	positive
gentlest	positive
barbarous	negative
unaccustomed	negative
bleakness	negative
disaccord	negative
smudged	negative
rejoice	positive
biting	negative
flexible	positive
inflict	negative
racist	negative
disfavor	negative
palatial	positive
painless	positive
discoutinous	negative
unjustly	negative
untested	negative
luxuriant	positive
perplex	negative
promising	positive
obstructs	negative
unusable	negative
negation	negative
chaos	negative
insinuate	negative
struggled	negative
hotcake	positive
selfishness	negative
oddities	negative
wimpy	negative
smudge	negative
disapproval	negative
intuitive	positive
shoddy	negative
forfeit	negative
ambiguity	negative
discomfort	negative
adventurous	positive
miscellaneous	negative
persecution	negative
uncomfy	negative
scornful	negative
pariah	negative
scandel	negative
steadiest	positive
foolish	negative
unhappiness	negative
joy	positive
endorsed	positive
precipitous	negative
infamous	negative
misunderstandings	negative
illness	negative
gallantly	positive
downheartedly	negative
dawn	positive
eminent	positive
compulsive	negative
dishonest	negative
screwy	negative
detest	negative
unproves	negative
skillfully	positive
glut	negative
warp	negative
dispirited	negative
negligence	negative
unwell	negative
soothe	positive
imperfect	negative
indiscriminate	negative
breathlessness	positive
friendliness	positive
unabashed	positive
monumentally	positive
inequality	negative
fancinating	positive
slogs	negative
intrude	negative
brave	positive
instability	negative
two-faced	negative
complacent	negative
farce	negative
smoothes	positive
flickers	negative
fiery	positive
frets	negative
revert	negative
silly	negative
chagrin	negative
frolic	positive
helping	positive
dastardly	negative
unclean	negative
debasement	negative
blandish	negative
audaciously	negative
charitable	positive
reassure	positive
irked	negative
problem	negative
multi-purpose	positive
pernicious	negative
ricer	negative
lie	negative
brutality	negative
ineffectual	negative
tout	negative
rusty	negative
righten	positive
debaser	negative
succeeds	positive
kaput	negative
condescend	negative
reforming	positive
befoul	negative
helplessness	negative
direness	negative
invidiously	negative
injury	negative
bent	negative
fearlessly	positive
playful	positive
eulogize	positive
interfere	negative
breakups	negative
formidable	positive
unselfish	positive
contentious	negative
inefficacious	negative
pervasive	negative
smooth	positive
perish	negative
pardon	positive
patiently	positive
unacceptable	negative
bothered	negative
inpressed	positive
exhausted	negative
bestial	negative
disadvantaged	negative
tragedy	negative
ignore	negative
aching	negative
spade	negative
keen	positive
zeal	positive
over-balanced	negative
misunderstanding	negative
top-heavy	negative
flawless	positive
witty	positive
sermonize	negative
boycott	negative
idolized	positive
upgraded	positive
masterful	positive
disparage	negative
suffered	negative
exagerate	negative
gangster	negative
sunder	negative
audiciously	negative
desiccated	negative
defamatory	negative
obsessions	positive
horrified	negative
dignity	positive
craftily	negative
overtaxed	negative
revolting	negative
concessions	negative
unprove	negative
exasperated	negative
perilously	negative
deceptive	negative
beckoned	positive
enflame	negative
unexpectedly	negative
defiant	negative
fascination	positive
abominate	negative
decrement	negative
stabilize	positive
pointlessly	negative
spews	negative
hopeful	positive
stimulating	positive
bump	negative
super	positive
hell-bent	negative
ardor	positive
gnawing	negative
horrible	negative
loathsomely	negative
overjoyed	positive
vicious	negative
skulk	negative
sever	negative
loses	negative
useful	positive
lowly	negative
complementary	positive
detracted	negative
earnestly	positive
triumphantly	positive
replaceable	positive
fortunately	positive
stressfully	negative
grandeur	positive
perfunctory	negative
masters	positive
galling	negative
solicitous	positive
shake	negative
usurp	negative
cataclysm	negative
bruise	negative
shortage	negative
diappointed	negative
sloow	negative
graft	negative
compact	positive
hothead	negative
dispirit	negative
untimely	negative
demonized	negative
shortness	negative
repression	negative
killer	negative
decency	positive
agonies	negative
horrifying	negative
capriciousness	negative
detests	negative
stuck	negative
gravely	negative
unauthentic	negative
miscalculation	negative
dogged	negative
crafty	negative
fried	negative
throbs	negative
burden	negative
embarrassment	negative
pan	negative
whips	negative
finest	positive
demon	negative
unpleasant	negative
dominates	positive
oblivious	negative
thrilled	positive
feeble	negative
achievement	positive
unnatural	negative
passe	negative
gutter	negative
domineer	negative
lunatic	negative
discomfit	negative
cynicism	negative
receptive	positive
bitch	negative
uproarously	negative
dauntingly	negative
dropout	negative
felonious	negative
foolishness	negative
zippy	positive
fraught	negative
cataclysmic	negative
faint	negative
rewarding	positive
jumpy	negative
decry	negative
dedicated	positive
hurts	negative
incorrigibly	negative
elite	positive
dizzingly	negative
conceited	negative
childish	negative
traction	positive
invective	negative
dishearten	negative
diabolical	negative
overrated	negative
humility	positive
dismally	negative
dirty	negative
miscalculate	negative
suppression	negative
inflated	negative
indecisively	negative
languorously	negative
thrilling	positive
futurestic	positive
swelling	negative
cleanliness	positive
blur	negative
bum	negative
wounds	negative
cringe	negative
pamperedness	positive
cashbacks	positive
lame	negative
second-tier	negative
rattle	negative
naÔve	negative
impolitic	negative
grumpish	negative
melodramatically	negative
disown	negative
detesting	negative
incomprehensible	negative
plot	negative
lucky	positive
unaccessible	negative
discomfititure	negative
inviolate	positive
discontinued	negative
disregard	negative
occlude	negative
bullish	positive
well-balanced	positive
travesties	negative
faulty	negative
smartest	positive
cooperative	positive
disobedient	negative
winning	positive
admiring	positive
incendiary	negative
dripping	negative
assuring	positive
chide	negative
bullshyt	negative
monotonous	negative
emptiness	negative
jolt	negative
enjoyably	positive
error	negative
reformed	positive
disorderly	negative
undermine	negative
cheating	negative
irritate	negative
perfidious	negative
hatefully	negative
breaks	negative
splitting	negative
lifeless	negative
fracture	negative
aspersion	negative
vibrates	negative
peacefully	positive
resigned	negative
illuminate	positive
thoughtful	positive
smut	negative
insignificance	negative
impoverish	negative
pinnacle	positive
implication	negative
burdensomely	negative
concise	positive
hung	negative
wrangle	negative
conscons	negative
dumps	negative
distrust	negative
excessive	negative
inconceivably	negative
gladly	positive
bonus	positive
stupendous	positive
ineffectiveness	negative
embarrassing	negative
predicament	negative
unnerving	negative
hedonistic	negative
deadlock	negative
itch	negative
captivating	positive
savagery	negative
erratically	negative
disarray	negative
crowdedness	negative
upbraid	negative
disconcerting	negative
decisiveness	positive
bloodthirsty	negative
bore	negative
fever	negative
lonesome	negative
crazily	negative
revives	positive
clueless	negative
loner	negative
braggart	negative
appalling	negative
deadly	negative
bigotry	negative
cramping	negative
skilled	positive
desperate	negative
wrongful	negative
gruesomely	negative
heartening	positive
relief	positive
ideally	positive
acridness	negative
uncontrolled	negative
invisible	negative
malevolently	negative
fat	negative
impending	negative
erroneously	negative
mockeries	negative
obtainable	positive
disappoints	negative
victory	positive
deception	negative
crush	negative
affectionate	positive
courteous	positive
lagging	negative
hedge	negative
altruistic	positive
ignominiously	negative
blunders	negative
distressed	negative
left-leaning	negative
stirringly	positive
catastrophies	negative
versatile	positive
crumble	negative
disillusionment	negative
slanderously	negative
melodramatic	negative
snagging	negative
despondently	negative
maniacal	negative
unworkable	negative
reconciliation	positive
immoderately	negative
pampers	positive
inexplainable	negative
hypocrite	negative
incitement	negative
naughty	negative
squealing	negative
affordably	positive
earnest	positive
tacky	negative
modern	positive
amaze	positive
malignant	negative
shortcoming	negative
affectation	positive
user-friendly	positive
muscle-flexing	negative
prohibitively	negative
snare	negative
prompt	positive
bane	negative
brazenness	negative
overpayed	negative
misreading	negative
fragrant	positive
tenuous	negative
prejudicial	negative
incomparable	negative
adversary	negative
self-interest	negative
overzealous	negative
irredeemably	negative
illegal	negative
archaic	negative
refinement	positive
defiantly	negative
slowww	negative
high-priced	negative
intriguingly	positive
rosy	positive
mocks	negative
inaccurate	negative
idiot	negative
sorely	negative
losses	negative
stunned	positive
mocked	negative
blockhead	negative
lovable	positive
faithfully	positive
mind-blowing	positive
carelessness	negative
costlier	negative
brand-new	positive
noteworthy	positive
devoid	negative
spinster	negative
obliterate	negative
undermines	negative
disaffect	negative
cure	positive
contrive	negative
sadden	negative
tangle	negative
mundane	negative
admirably	positive
dropouts	negative
insanity	negative
spook	negative
sociable	positive
prosper	positive
refutation	negative
thwart	negative
lacked	negative
fallaciousness	negative
headache	negative
bombastic	negative
peaceable	positive
prefers	positive
falls	negative
respectable	positive
issue-free	positive
ebullient	positive
lunaticism	negative
solid	positive
seasoned	positive
corrupt	negative
neglected	negative
harass	negative
strain	negative
sketchy	negative
uproar	negative
belligerent	negative
misleadingly	negative
well-rounded	positive
massacre	negative
impressed	positive
spoiled	negative
procrastinates	negative
hostage	negative
sweetheart	positive
notably	positive
trapped	negative
beutifully	positive
disrespect	negative
sweeping	positive
warily	negative
intriguing	positive
lovably	positive
grieve	negative
disapproving	negative
aborts	negative
overstatements	negative
succumb	negative
incapably	negative
eye-catching	positive
obscene	negative
enemy	negative
inaccuracies	negative
manipulate	negative
detested	negative
refunded	positive
swiftness	positive
better	positive
disagreed	negative
worked	positive
fortuitously	positive
demonize	negative
repugn	negative
virtuously	positive
smoothly	positive
fears	negative
improved	positive
killed	negative
fool	negative
draconian	negative
disdainful	negative
messes	negative
vent	negative
contentment	positive
harmonious	positive
defensive	negative
beloved	positive
extraneous	negative
tricked	negative
preeminent	positive
messed	negative
ennoble	positive
reproach	negative
saintly	positive
wins	positive
beneficially	positive
evade	negative
idyllic	positive
assurance	positive
feeblely	negative
dextrous	positive
vomits	negative
wickedly	negative
confused	negative
prodigiously	positive
fertile	positive
commiserate	negative
entranced	positive
distinguished	positive
despair	negative
amicable	positive
unwillingness	negative
arrogantly	negative
dishonor	negative
foolproof	positive
gold	positive
uneasiness	negative
gawky	negative
pretty	positive
malevolence	negative
accurate	positive
smallish	negative
gruesome	negative
redeeming	positive
crumpled	negative
adaptive	positive
onslaught	negative
bizarre	negative
gem	positive
masterpiece	positive
advantageous	positive
fatalistically	negative
ill-fated	negative
sabotage	negative
disconsolately	negative
loyal	positive
illogical	negative
non-confidence	negative
excellant	positive
slumpping	negative
unneeded	negative
caricature	negative
dissing	negative
snub	negative
hesitant	negative
supported	positive
shimmering	positive
implausible	negative
champ	positive
handicapped	negative
goood	positive
irk	negative
overwhelms	negative
dissatisfied	negative
refresh	positive
effusive	positive
coercion	negative
creaking	negative
bunk	negative
exploitation	negative
evasion	negative
weak	negative
expensive	negative
lawlessness	negative
unwillingly	negative
pleasure	positive
vulgar	negative
rapture	positive
mortification	negative
dissappointing	negative
misconceptions	negative
matchless	positive
disturbing	negative
compatible	positive
knave	negative
suspiciously	negative
flourish	positive
unjust	negative
vibrantly	positive
speedily	positive
encouraging	positive
humorously	positive
mischievously	negative
enervate	negative
precious	positive
shit	negative
frustrates	negative
fascinate	positive
stormy	negative
menace	negative
disregardful	negative
fortuitous	positive
sufficed	positive
primitive	negative
filthy	negative
temerity	negative
refuted	negative
deviation	negative
complication	negative
hollow	negative
prik	negative
brutalize	negative
long-time	negative
jam	negative
acrimony	negative
haughty	negative
backwardness	negative
cancer	negative
lean	positive
stale	negative
drunkard	negative
insanely	negative
anarchism	negative
simplistic	negative
distorted	negative
aggravate	negative
beggarly	negative
apotheosis	positive
repressive	negative
moronic	negative
cowardly	negative
unemployed	negative
tougher	positive
confess	negative
glaringly	negative
poetic	positive
disconsolation	negative
promises	positive
helpful	positive
relentlessness	negative
splatter	negative
conspicuous	negative
roomier	positive
disturbingly	negative
fulminate	negative
ease	positive
whores	negative
diabolically	negative
disagreeably	negative
hell	negative
longingly	negative
horrid	negative
unproductive	negative
scared	negative
concern	negative
triumphant	positive
despairingly	negative
wrong	negative
terrifically	positive
disobey	negative
hastily	negative
energy-efficient	positive
grainy	negative
macabre	negative
unsafe	negative
mistrustfully	negative
traumatic	negative
geezer	negative
obstructed	negative
fast	positive
droops	negative
exploit	negative
coercive	negative
grudges	negative
clumsy	negative
stampede	negative
jittery	negative
examplary	positive
apathetic	negative
enhances	positive
inconsistence	negative
massacres	negative
matte	negative
infringement	negative
coolest	positive
enticing	positive
imperfectly	negative
exhorbitant	negative
odder	negative
immobilized	negative
divine	positive
furious	negative
unfaithful	negative
lonely	negative
bitter	negative
objection	negative
pest	negative
raging	negative
glitches	negative
aggressive	negative
ready	positive
trump	positive
unraveled	negative
sack	negative
funky	negative
jubilant	positive
belligerence	negative
accidental	negative
timely	positive
instable	negative
deformed	negative
battering	negative
ridiculously	negative
fiction	negative
cringed	negative
distress	negative
jabber	negative
recalcitrant	negative
distasteful	negative
traitorous	negative
spookier	negative
narrower	negative
appropriate	positive
joyfully	positive
anemic	negative
tingle	positive
kindly	positive
truthful	positive
deceivers	negative
reprehensible	negative
annoy	negative
optimal	positive
brighter	positive
prisoner	negative
traitorously	negative
insurmountably	negative
nuisance	negative
disconcert	negative
admonition	negative
foolishly	negative
unintelligible	negative
standstill	negative
reliably	positive
miff	negative
unknown	negative
pamperedly	positive
absurd	negative
delighted	positive
ugly	negative
mess	negative
viewable	positive
dimmer	negative
overreach	negative
fatuous	negative
freakish	negative
indoctrination	negative
hazardous	negative
protection	positive
prattle	negative
desirous	positive
suffering	negative
resourcefulness	positive
over-valuation	negative
sued	negative
skeptic	negative
scar	negative
eloquent	positive
breakup	negative
incite	negative
misjudge	negative
sue	negative
affinity	positive
conscientious	positive
tyrannical	negative
unproving	negative
complimentary	positive
snobbish	negative
boundless	positive
unreal	positive
oasis	positive
exterminate	negative
meticulously	positive
racism	negative
harrow	negative
coarse	negative
creeps	negative
tenderly	positive
assassin	negative
fidgety	negative
incoherently	negative
wrinkles	negative
unabashedly	positive
sags	negative
stutter	negative
horrify	negative
desolately	negative
dubious	negative
economical	positive
opinionated	negative
ignorant	negative
plunder	negative
shamefulness	negative
divinely	positive
frenetically	negative
somber	negative
fusty	negative
ill-natured	negative
magnificently	positive
collude	negative
deviousness	negative
impeach	negative
absent-minded	negative
disasterous	negative
satirical	negative
disagreeing	negative
tremendously	positive
liability	negative
fleed	negative
degrading	negative
worthlessness	negative
allege	negative
exonerate	positive
leakage	negative
graciousness	positive
offence	negative
improves	positive
mistrustful	negative
heinous	negative
honesty	positive
stimulative	positive
satisfy	positive
shimmy	negative
fist	negative
remarkably	positive
slogged	negative
ineffectually	negative
panick	negative
pales	negative
cutthroat	negative
declining	negative
snobish	negative
glitter	positive
astound	positive
unequal	negative
gains	positive
sharper	positive
horrendous	negative
dominated	positive
wripped	negative
misleading	negative
rebellious	negative
dragoon	negative
stately	positive
enjoin	negative
loud	negative
displeasing	negative
misinterpret	negative
crumple	negative
phobia	negative
tin-y	negative
killing	negative
perverse	negative
hardened	negative
falsely	negative
convincingly	positive
attentive	positive
bashed	negative
unruly	negative
contradictory	negative
cry	negative
misunderstand	negative
glisten	positive
execrate	negative
lesser-known	negative
ultra-crisp	positive
spurn	negative
outwit	positive
damned	negative
gloatingly	negative
disallow	negative
atrocity	negative
hysteria	negative
downcast	negative
frigid	negative
drains	negative
viciousness	negative
overweight	negative
miserableness	negative
magnanimously	positive
aghast	negative
perfect	positive
regrettable	negative
plebeian	negative
stresses	negative
adverse	negative
flagrantly	negative
wane	negative
gripe	negative
protracted	negative
weariness	negative
blurt	negative
agreeableness	positive
advanced	positive
sickeningly	negative
swelled	negative
destructive	negative
bonkers	negative
gimmick	negative
impulsive	negative
fright	negative
virulent	negative
hero	positive
carefree	positive
bombardment	negative
inefficacy	negative
happiness	positive
stagnate	negative
puppet	negative
mortified	negative
rusts	negative
surreal	positive
infirm	negative
latency	negative
incompatible	negative
animosity	negative
worried	negative
noiseless	positive
sagged	negative
pickets	negative
culpable	negative
absurdity	negative
stingy	negative
imperialist	negative
leech	negative
relapse	negative
nebulously	negative
douchbag	negative
bloody	negative
mistakenly	negative
accursed	negative
accommodative	positive
greed	negative
embroiled	negative
egregiously	negative
non-violence	positive
sugarcoated	negative
improving	positive
sharpest	positive
misconception	negative
dissidents	negative
envy	positive
shameless	negative
embarrassingly	negative
sunken	negative
jaw-dropping	positive
smelt	negative
kills	negative
subpoena	negative
calm	positive
loathsome	negative
pain-free	positive
hellion	negative
mediocrity	negative
cheap	negative
venom	negative
brilliances	positive
hypocritically	negative
fibber	negative
fastidiously	negative
disgusting	negative
partiality	negative
delicious	positive
unuseable	negative
preferably	positive
implicate	negative
privileged	positive
undersized	negative
jitters	negative
bumping	negative
complicated	negative
inestimably	positive
obliterated	negative
loveless	negative
resentment	negative
slowly	negative
procrastinate	negative
hobble	negative
felicity	positive
discouragingly	negative
reaffirmation	positive
stupidest	negative
hostilities	negative
obstruction	negative
puny	negative
commitment	positive
zealously	negative
unassailable	positive
busybody	negative
involuntarily	negative
inelegant	negative
contention	negative
enthusiastically	positive
calming	positive
liking	positive
unlawfulness	negative
nonresponsive	negative
protest	negative
fun	positive
displaced	negative
sustainable	positive
dismayed	negative
thoughtlessly	negative
admonishingly	negative
inescapable	negative
maturely	positive
admirer	positive
bashing	negative
hardheaded	negative
harsh	negative
rockstars	positive
dust	negative
butchery	negative
disavowal	negative
prickles	negative
progressive	positive
orderly	positive
rot	negative
insulting	negative
testily	negative
entangle	negative
counterproductive	negative
authentic	positive
odor	negative
revoke	negative
redeem	positive
buggy	negative
sag	negative
tolerable	positive
afflictive	negative
engrossing	positive
pleasurable	positive
unimportant	negative
tumultuous	negative
simplifying	positive
apprehensions	negative
washed-out	negative
well-informed	positive
costly	negative
pricey	negative
discontented	negative
disconcerted	negative
innovation	positive
guilt	negative
dejection	negative
sob	negative
dislocated	negative
unreliable	negative
angrily	negative
unnervingly	negative
assassinate	negative
interruption	negative
betray	negative
sporty	positive
vivid	positive
farfetched	negative
blessing	positive
shrew	negative
exceeded	positive
terror-genic	negative
smart	positive
provocation	negative
blithe	positive
desultory	negative
underdog	negative
rift	negative
demoralize	negative
traitor	negative
reachable	positive
reluctantly	negative
prejudge	negative
posh	positive
gape	negative
ineffectively	negative
flat-out	negative
discountenance	negative
upsets	negative
hurting	negative
pig	negative
detracts	negative
brashly	negative
noble	positive
purify	positive
stubbornly	negative
snobby	negative
hoax	negative
taxing	negative
shameful	negative
feasible	positive
tenaciously	positive
unnecessary	negative
commendable	positive
bonuses	positive
downhearted	negative
sloth	negative
righteously	positive
un-viewable	negative
snob	negative
insatiable	negative
awestruck	positive
pride	positive
risk	negative
afford	positive
laudable	positive
aspirations	positive
loneliness	negative
anti-us	negative
perversion	negative
unfortunate	negative
strikingly	positive
pleasant	positive
hustler	negative
virulently	negative
mocking	negative
suppress	negative
wows	positive
insults	negative
involuntary	negative
wrestle	negative
derogatory	negative
ploy	negative
fails	negative
promised	positive
donside	negative
rabid	negative
mourn	negative
efficiently	positive
bleeding	negative
mesmerizing	positive
inflammed	negative
pessimistically	negative
touted	negative
magic	positive
hothouse	negative
parasite	negative
capsize	negative
kindliness	positive
succeeding	positive
frozen	negative
needlessly	negative
hum	negative
pretense	negative
hegemony	negative
spontaneous	positive
humour	positive
unparalleled	positive
adjustable	positive
dupe	negative
pleasurably	positive
romanticize	positive
evildoer	negative
idiocy	negative
prohibit	negative
trick	negative
luckiness	positive
overtakes	positive
naive	negative
loathe	negative
gusto	positive
condemnation	negative
measly	negative
threat	negative
tempest	negative
amply	positive
variety	positive
commend	positive
illusion	negative
forsake	negative
alarming	negative
oppositions	negative
irresponsibly	negative
transgression	negative
honor	positive
tormented	negative
serene	positive
discord	negative
consistent	positive
indignant	negative
egotistically	negative
sub-par	negative
pretend	negative
pugnaciously	negative
retards	negative
advantageously	positive
irks	negative
luminous	positive
agreeably	positive
laid-off	negative
weird	negative
pry	negative
rumple	negative
second-class	negative
fondly	positive
drain	negative
musty	negative
wasting	negative
futilely	negative
multi-polarization	negative
mediocre	negative
top	positive
controversial	negative
achievements	positive
marvelous	positive
dent	negative
stuffy	negative
valiantly	positive
enthuse	positive
infernal	negative
obsessively	negative
peeled	negative
sharp	positive
elevate	positive
supreme	positive
forsaken	negative
expansive	positive
undesirable	negative
gabble	negative
fuck	negative
mispronounced	negative
culprit	negative
gibber	negative
weakness	negative
flaws	negative
danger	negative
inconsistent	negative
tranquil	positive
refutes	negative
assult	negative
contend	negative
babble	negative
nitpicking	negative
ambush	negative
anti-white	negative
doggedly	negative
picketing	negative
egregious	negative
exquisitely	positive
lecher	negative
impose	negative
stressful	negative
disrepute	negative
fooled	negative
recommend	positive
overwhelming	negative
woeful	negative
feebleminded	negative
faltered	negative
smash	negative
degrade	negative
addicted	negative
quash	negative
disgraced	negative
eruptions	negative
dissatisfy	negative
easing	positive
sty	negative
motionless	negative
suffocate	negative
squirm	negative
glare	negative
starkly	negative
rebuke	negative
disparagingly	negative
mercy	positive
rejuvenated	positive
enthralled	positive
unfulfilled	negative
well-backlit	positive
talents	positive
hideousness	negative
strange	negative
honoring	positive
time-consuming	negative
conspicuously	negative
fortune	positive
pamper	positive
onerous	negative
discouragement	negative
immoral	negative
hateful	negative
vileness	negative
rejects	negative
unhappy	negative
rupture	negative
imminence	negative
bothering	negative
amputate	negative
thug	negative
one-sided	negative
sincere	positive
conflicting	negative
gallingly	negative
subpoenas	negative
endorse	positive
martyrdom-seeking	negative
stealing	negative
incredulous	negative
perfidity	negative
bewildered	negative
preposterous	negative
defamations	negative
break	negative
stimulate	positive
problem-solver	positive
approve	positive
threatening	negative
fav	positive
shipwreck	negative
set-up	negative
grossly	negative
guilty	negative
wily	negative
ignominy	negative
loser	negative
free	positive
improper	negative
lively	positive
inhuman	negative
abounds	positive
navigable	positive
swank	positive
quarrels	negative
blather	negative
combative	negative
stringently	negative
pricier	negative
gaff	negative
unappealing	negative
displease	negative
pimple	negative
poorest	negative
glum	negative
dummy-proof	positive
magnificent	positive
chatterbox	negative
beautify	positive
mar	negative
repugnance	negative
aggravation	negative
adroitly	positive
unworthy	negative
choleric	negative
gratifying	positive
irrational	negative
mightily	positive
stunt	negative
ambivalent	negative
drowning	negative
interferes	negative
falling	negative
impinge	negative
grimace	negative
distrusting	negative
dissed	negative
sparkling	positive
venerate	positive
feign	negative
hard-working	positive
warmer	positive
amicability	positive
awesome	positive
dings	negative
inferior	negative
reasonable	positive
better-than-expected	positive
officious	negative
unpleasantries	negative
mesmerize	positive
irreplacible	negative
addicts	negative
obtrusive	negative
astutely	positive
unsuccessful	negative
insufficiency	negative
enthusiastic	positive
willingness	positive
righteous	positive
peevish	negative
emasculate	negative
clogs	negative
contaminate	negative
taint	negative
impatient	negative
precarious	negative
breakdown	negative
fanatic	negative
terrific	positive
cronyism	negative
generosity	positive
overheat	negative
symptom	negative
unmoved	negative
blasphemy	negative
lawbreaking	negative
awards	positive
incompatability	negative
adulterate	negative
dangerousness	negative
refute	negative
repetitive	negative
chill	negative
troublemaker	negative
unproved	negative
heroically	positive
deprived	negative
torturously	negative
splendor	positive
aspersions	negative
qualified	positive
swift	positive
offender	negative
diplomatic	positive
morons	negative
overbearingly	negative
clog	negative
crook	negative
assault	negative
avariciously	negative
innocuous	positive
favorited	positive
torturing	negative
stress	negative
ghastly	negative
hazy	negative
aggression	negative
askance	negative
quieter	positive
shallow	negative
counter-attack	positive
shimmer	negative
agreeable	positive
harmful	negative
inflexible	negative
swipe	negative
corrosive	negative
benefits	positive
abominably	negative
elation	positive
defrauding	negative
laggy	negative
indiscretion	negative
bedlamite	negative
unhealthy	negative
calamities	negative
backbone	positive
disvalue	negative
frightful	negative
stew	negative
scornfully	negative
mangles	negative
impoverished	negative
powerless	negative
exasperating	negative
outbursts	negative
maddeningly	negative
poeticize	positive
castrated	negative
sobering	negative
rants	negative
stringent	negative
ecstasies	positive
imposition	negative
overpaid	negative
unkind	negative
blindside	negative
disingenuous	negative
delightful	positive
overawe	negative
split	negative
keenness	positive
unlawful	negative
sturdier	positive
rumor	negative
desirable	positive
scarcity	negative
vigilant	positive
reprehension	negative
advantages	positive
irritable	negative
ill-defined	negative
debilitating	negative
bigotries	negative
disgustingly	negative
mania	negative
uproarious	negative
dissonantly	negative
disruptive	negative
craven	negative
wariness	negative
celebratory	positive
subjected	negative
scratched	negative
dragging	negative
pillory	negative
criticized	negative
evils	negative
stumbled	negative
strangely	negative
integral	positive
foresight	positive
bulkiness	negative
subjection	negative
slaughter	negative
mushy	negative
inventive	positive
rubbish	negative
sap	negative
disbelieve	negative
impassioned	positive
disparaging	negative
pathetic	negative
oddly	negative
disgrace	negative
discombobulate	negative
comforting	positive
flounder	negative
ridicules	negative
pity	negative
invincible	positive
lengthy	negative
scars	negative
hardship	negative
falsehood	negative
unjustifiable	negative
injurious	negative
providence	positive
indiscriminating	negative
recommended	positive
dissappointed	negative
injustice	negative
frustrated	negative
mortify	negative
exaggerate	negative
rip-off	negative
fine-looking	positive
affably	positive
superficiality	negative
flee	negative
baffling	negative
insufficient	negative
large-capacity	positive
chaff	negative
generously	positive
imprudent	negative
dumped	negative
impartial	positive
lucidly	positive
shark	negative
demise	negative
fidelity	positive
petrified	negative
unwavering	positive
gentle	positive
intransigent	negative
ebulliently	positive
rattles	negative
offending	negative
danke	positive
vagueness	negative
polluter	negative
disputable	negative
nauseate	negative
ergonomical	positive
sues	negative
honest	positive
stump	negative
err	negative
rogue	negative
noxious	negative
contemptuous	negative
pitiless	negative
inequalities	negative
proprietary	negative
recant	negative
encouragingly	positive
heedless	negative
miracles	positive
invigorating	positive
fabricate	negative
fucking	negative
discontinuity	negative
inaptitude	negative
pertinacity	negative
acrimoniously	negative
tingled	negative
disappointment	negative
happy	positive
hopelessness	negative
suave	positive
desiring	positive
sting	negative
fetid	negative
unfettered	positive
irresistibly	positive
ineptitude	negative
faster	positive
rejoicingly	positive
unaffordable	negative
imperil	negative
debacle	negative
hail	positive
peevishly	negative
hideous	negative
fond	positive
swankiest	positive
fatcats	negative
gush	positive
complemented	positive
confidence	positive
dumb	negative
uncollectible	negative
promptly	positive
peculiar	negative
hardships	negative
gracelessly	negative
dictatorial	negative
obsession	positive
skill	positive
scandal	negative
protect	positive
irritated	negative
catastrophe	negative
dead-on	positive
nervous	negative
gainful	positive
undissolved	negative
sincerity	positive
menial	negative
panoramic	positive
unfeeling	negative
injudicious	negative
castigate	negative
staunchness	positive
apprehension	negative
elatedly	positive
irrecoverable	negative
grouse	negative
peerless	positive
appreciable	positive
tedious	negative
negligent	negative
adulteration	negative
adulterier	negative
illegally	negative
impropriety	negative
lackey	negative
irritant	negative
barbarity	negative
ardently	positive
poisonously	negative
discourteous	negative
accusation	negative
earnestness	positive
farcically	negative
hurted	negative
crumples	negative
effusively	positive
shamelessly	negative
knife	negative
rant	negative
shortsightedness	negative
insubstantial	negative
barbaric	negative
gutsy	positive
clunky	negative
evocative	positive
stuttered	negative
brotherly	positive
boil	negative
accusing	negative
doubtfully	negative
credible	positive
hooray	positive
belated	negative
decay	negative
acerbically	negative
harasses	negative
fatcat	negative
insupportably	negative
hale	positive
irretating	negative
deadweight	negative
baffle	negative
dire	negative
runaway	negative
bulky	negative
appall	negative
fresher	positive
passion	positive
spoilages	negative
contemptuously	negative
embolden	positive
gutless	negative
miserly	negative
unnerve	negative
touts	negative
world-famous	positive
snags	negative
untrue	negative
flaking	negative
funny	negative
silent	positive
ecstasy	positive
devil	negative
gaffe	negative
disagrees	negative
convience	positive
displace	negative
deprive	negative
prevaricate	negative
hypocrisy	negative
confrontation	negative
debilitate	negative
fanaticism	negative
slow-moving	negative
fiend	negative
shortchange	negative
discouraging	negative
bright	positive
feckless	negative
entrust	positive
cartoonish	negative
forgetful	negative
inopportune	negative
cashback	positive
togetherness	positive
sarcastically	negative
outstanding	positive
unipolar	negative
harpy	negative
blossom	positive
spellbound	positive
hells	negative
optimism	positive
disreputable	negative
nemesis	negative
admonisher	negative
dislike	negative
sinful	negative
acerbic	negative
chatter	negative
pauper	negative
satisfactory	positive
vanity	negative
cohere	positive
loved	positive
blameless	positive
morbidly	negative
impetuously	negative
disadvantageous	negative
asunder	negative
nourishing	positive
smells	negative
subservient	negative
insolence	negative
incongruously	negative
awesomely	positive
adorable	positive
wonderful	positive
willingly	positive
sickness	negative
excoriate	negative
useable	positive
unsavory	negative
paucity	negative
lost	negative
devastatingly	negative
jealousness	negative
spoonfed	negative
unconditional	positive
distraughtness	negative
fractiously	negative
unscrupulous	negative
midget	negative
payback	negative
frustrating	negative
monumental	positive
goofy	negative
nauseatingly	negative
disapprove	negative
skittish	negative
detrimental	negative
hardball	negative
inaccurately	negative
indignation	negative
agility	positive
overbalanced	negative
fair	positive
stigmatize	negative
jagged	negative
beautifullly	positive
tainted	negative
accuse	negative
fudge	negative
invasive	negative
tattered	negative
ferociously	negative
sunk	negative
ulterior	negative
watered-down	negative
fanciful	negative
cash-strapped	negative
snappishly	negative
abundance	positive
enterprising	positive
refreshed	positive
jeers	negative
vibrate	negative
nag	negative
revolutionized	positive
trashy	negative
scrap	negative
endear	positive
spoon-feed	negative
misinform	negative
sardonic	negative
strenuous	negative
slothful	negative
maladjusted	negative
wieldy	positive
consternation	negative
unencumbered	positive
deprecate	negative
contrariness	negative
coldly	negative
vainly	negative
rapt	positive
laughable	negative
disconsolate	negative
manipulation	negative
mire	negative
civility	positive
persecute	negative
weirdly	negative
undisputed	positive
fallen	negative
imprecise	negative
paradise	positive
shemale	negative
offensive	negative
stricken	negative
enthral	positive
oppressors	negative
contempt	negative
blurry	negative
self-sufficiency	positive
convenient	positive
cohesive	positive
incompliant	negative
affliction	negative
baseless	negative
tauntingly	negative
flees	negative
curt	negative
mishandle	negative
whooa	positive
insult	negative
losing	negative
mesmerizes	positive
distraughtly	negative
villianously	negative
exemplary	positive
crass	negative
amusing	positive
stuttering	negative
outcry	negative
achievible	positive
irksomenesses	negative
facilitate	positive
enthusiast	positive
insensitivity	negative
irrecoverably	negative
overact	negative
lying	negative
weep	negative
compulsion	negative
inadequate	negative
hilarious	positive
significant	positive
emergency	negative
celebration	positive
incorrect	negative
marvellous	positive
grumpy	negative
equitable	positive
limited	negative
prosperity	positive
impiety	negative
cliched	negative
upbeat	positive
fury	negative
uproarous	negative
courtly	positive
deteriorating	negative
afraid	negative
forgetfulness	negative
compliment	positive
safe	positive
chic	positive
ineffective	negative
acumen	positive
proud	positive
damaged	negative
amity	positive
inexcusable	negative
infest	negative
fervently	positive
starve	negative
enrich	positive
reproachful	negative
distressing	negative
leads	positive
caustic	negative
agony	negative
discriminatory	negative
poison	negative
blatant	negative
entertaining	positive
risk-free	positive
enemies	negative
penalize	negative
disoobedient	negative
gorgeous	positive
inadverently	negative
struggle	negative
unfamiliar	negative
defiler	negative
deprave	negative
virtue	positive
breakthroughs	positive
devilment	negative
heretic	negative
depress	negative
charismatic	positive
dispute	negative
heavenly	positive
barbarically	negative
fabulous	positive
dissemble	negative
flakey	negative
junky	negative
legendary	positive
rejuvenating	positive
abusive	negative
grumble	negative
hestitant	negative
solemn	negative
back-woods	negative
cost-saving	positive
verifiable	positive
unsupportive	negative
audacity	negative
greatness	positive
inexpert	negative
propaganda	negative
cuteness	positive
contagious	negative
unorthodox	negative
calumnious	negative
lawless	negative
distaste	negative
desititute	negative
inefficiency	negative
outperform	positive
rational	positive
uproariously	negative
fractious	negative
militancy	negative
skeptically	negative
shirk	negative
bemoan	negative
spank	negative
bribery	negative
defeating	positive
outdone	positive
steadfastness	positive
crabby	negative
overemphasize	negative
indiscreetly	negative
obstinate	negative
precisely	positive
incompetent	negative
congratulation	positive
unsound	negative
satisfactorily	positive
risks	negative
kook	negative
ill-favored	negative
unacceptably	negative
soundly	positive
bravery	positive
worsen	negative
insecurity	negative
exalt	positive
well-received	positive
tragic	negative
shambles	negative
misery	negative
flimflam	negative
missed	negative
breathtakingly	positive
groundless	negative
dirt-cheap	positive
meddlesome	negative
ominously	negative
unbound	positive
warped	negative
whiny	negative
rivalry	negative
harms	negative
simplify	positive
stronger	positive
scolded	negative
realizable	positive
reverence	positive
provoke	negative
begging	negative
subtract	negative
infamously	negative
avid	positive
charming	positive
doubtless	positive
racists	negative
concerned	negative
unspecified	negative
unhappily	negative
dazzling	positive
valor	positive
pertinaciously	negative
well-connected	positive
extol	positive
insincerity	negative
disagree	negative
restrictive	negative
betrayer	negative
stains	negative
usurper	negative
tarnish	negative
brood	negative
unforeseen	negative
gratified	positive
pretentious	negative
expire	negative
conspiracy	negative
outstrip	positive
damages	negative
spirited	positive
overstated	negative
outsmart	positive
disproportionate	negative
chasten	negative
egomania	negative
brisk	positive
nosey	negative
swankier	positive
rejection	negative
discordance	negative
thriving	positive
assurances	positive
upseting	negative
decayed	negative
savvy	positive
shock	negative
squeal	negative
deteriorate	negative
incautious	negative
impulsively	negative
impatience	negative
havoc	negative
cheapest	positive
insinuation	negative
boost	positive
delays	negative
pure	positive
stiff	negative
rectification	positive
busts	negative
god-awful	negative
amicably	positive
tanks	negative
terribleness	negative
blackmail	negative
paradoxically	negative
over-acted	negative
discordant	negative
mournfully	negative
nauseating	negative
gritty	negative
steal	negative
refined	positive
easiest	positive
destabilisation	negative
straining	negative
fatefully	negative
plasticky	negative
breeze	positive
botch	negative
hissed	negative
outrage	negative
reputation	positive
delay	negative
troublingly	negative
degenerate	negative
wellbeing	positive
tantalize	positive
exaltation	positive
unbelievably	negative
flawed	negative
fretful	negative
inexorable	negative
impunity	negative
benevolence	positive
miraculously	positive
monstrously	negative
violent	negative
horrifys	negative
servitude	negative
satisified	positive
euphoric	positive
flareup	negative
low-price	positive
tortuous	negative
aspiration	positive
sidetracked	negative
electrify	positive
sorrowfully	negative
ferocity	negative
defeated	positive
warmth	positive
susceptible	negative
shrouded	negative
disintegration	negative
fraud	negative
enmity	negative
grudgingly	negative
treacherously	negative
cheapen	negative
cheated	negative
hallowed	positive
cherub	positive
patient	positive
pinch	negative
autonomous	positive
subversively	negative
drastically	negative
daring	positive
hack	negative
embroilment	negative
goading	negative
mashed	negative
repugnant	negative
war-like	negative
disgracefully	negative
beleaguer	negative
credulous	negative
windfall	positive
undependability	negative
doddering	negative
handsomely	positive
streaky	negative
surrender	negative
entanglement	negative
flicker	negative
nicest	positive
retaliatory	negative
correctly	positive
layoff-happy	negative
exceptional	positive
wretchedly	negative
admiration	positive
strike	negative
smudges	negative
ingeniously	positive
dashing	positive
civilize	positive
disillusion	negative
drones	negative
ill-treatment	negative
genuine	positive
dull	negative
idolize	positive
masterpieces	positive
overloaded	negative
untrustworthy	negative
convoluted	negative
hates	negative
pleasingly	positive
sagacity	positive
burns	negative
astonishingly	positive
loose	negative
horrifies	negative
lover	positive
obtuse	negative
unintelligile	negative
effusion	positive
haze	negative
favour	positive
stolen	negative
scare	negative
grief	negative
entrancing	positive
hogs	negative
tumbles	negative
restricted	negative
sensibly	positive
cuss	negative
heartbreaker	negative
sorry	negative
iniquitous	negative
misaligns	negative
unconfirmed	negative
disheartening	negative
brighten	positive
insincerely	negative
remorseless	negative
cheer	positive
indeterminable	negative
dejected	negative
lacking	negative
liar	negative
trickery	negative
throbbing	negative
backaches	negative
meaningful	positive
plentiful	positive
defy	negative
unsteady	negative
incapable	negative
felon	negative
sickening	negative
fancy	positive
tidy	positive
cheaply	negative
posturing	negative
repulse	negative
arrogance	negative
sinking	negative
fantastic	positive
dreary	negative
easiness	positive
humourous	positive
sweetness	positive
apathy	negative
ineffectualness	negative
scold	negative
whoooa	positive
disordered	negative
swollen	negative
ail	negative
rantingly	negative
rigidity	negative
catastrophic	negative
romantic	positive
senile	negative
nightmarishly	negative
savings	positive
devilish	negative
protests	negative
lyrical	positive
worrisome	negative
treasure	positive
mastery	positive
tickle	positive
titillatingly	positive
freedom	positive
illumine	positive
tarnishing	negative
anarchistic	negative
spellbind	positive
languor	negative
woebegone	negative
thank	positive
impossibly	negative
exquisite	positive
sourly	negative
underlings	negative
unreadable	negative
exasperatingly	negative
soapy	negative
regally	positive
resistance	negative
violators	negative
smile	positive
improvement	positive
abort	negative
extravagance	negative
polemize	negative
nettle	negative
wealthy	positive
entice	positive
gossip	negative
enrapture	positive
correct	positive
lewdly	negative
blabber	negative
sugar-coat	negative
unwelcome	negative
warm	positive
shady	negative
productive	positive
confident	positive
displeasure	negative
unfortunately	negative
deference	positive
choppy	negative
benefactor	positive
cramp	negative
chastisement	negative
perversity	negative
saggy	negative
chaste	positive
flickering	negative
disoriented	negative
leaking	negative
plaything	negative
aches	negative
worriedly	negative
facetiously	negative
frenzied	negative
restructure	positive
sacrificed	negative
scariest	negative
antagonistic	negative
naively	negative
guile	negative
everlasting	positive
retreated	negative
effective	positive
debaucher	negative
uncivil	negative
poised	positive
downsides	negative
well-behaved	positive
intrigue	positive
ethical	positive
venomous	negative
works	positive
tiresome	negative
puzzling	negative
deplorable	negative
prohibitive	negative
deform	negative
torrent	negative
stagnant	negative
led	positive
enhanced	positive
apocalyptic	negative
mordantly	negative
tiringly	negative
wretched	negative
mystery	negative
conflicts	negative
heckled	negative
fortitude	positive
hallmark	positive
disclaim	negative
belligerently	negative
nettlesome	negative
victorious	positive
authoritative	positive
indulgent	positive
devastation	negative
scandels	negative
debts	negative
interference	negative
bumped	negative
craps	negative
calmness	positive
originality	positive
daze	negative
romantically	positive
blaspheme	negative
awesomeness	positive
supporting	positive
stupify	negative
provocative	negative
danken	positive
vindictiveness	negative
spiritless	negative
spooky	negative
refuting	negative
totalitarian	negative
devastate	negative
disadvantages	negative
solidarity	positive
advocate	positive
infidels	negative
solicitude	negative
prejudices	negative
addicting	negative
stench	negative
cramped	negative
fuss	negative
sadness	negative
nobly	positive
unbeatable	positive
beggar	negative
bloom	positive
fairly	positive
implacable	negative
insincere	negative
harridan	negative
agonize	negative
charmingly	positive
squabble	negative
junk	negative
spoilage	negative
sneer	negative
dissatisfaction	negative
strong	positive
luckiest	positive
authoritarian	negative
impurity	negative
indifferent	negative
strangle	negative
damnably	negative
revengefully	negative
condescendingly	negative
smoother	positive
pleases	positive
unobserved	negative
refuse	negative
encourage	positive
confession	negative
sweet	positive
excelled	positive
excruciatingly	negative
obsess	negative
marginally	negative
allergic	negative
hiliarious	negative
stutters	negative
despicable	negative
imprecision	negative
brutal	negative
productively	positive
enlighten	positive
curses	negative
smell	negative
unexpected	negative
mesmerizingly	positive
unwarranted	negative
violently	negative
harm	negative
brilliance	positive
disrespectable	negative
unspeakable	negative
subsidizes	positive
bogus	negative
errors	negative
impartiality	positive
allergies	negative
mangled	negative
crummy	negative
heroic	positive
lugubrious	negative
scandals	negative
stooges	negative
paramount	positive
pluses	positive
remorse	negative
pleasing	positive
entertains	positive
poorer	negative
lead	positive
mockery	negative
principled	positive
enjoying	positive
threesome	negative
trivially	positive
saver	positive
vague	negative
divisiveness	negative
ruthlessness	negative
thrash	negative
heartless	negative
sin	negative
raping	negative
inextricably	negative
calumniate	negative
overblown	negative
poky	negative
trusted	positive
inflammatory	negative
prominent	positive
prudently	positive
antipathy	negative
blind	negative
explode	negative
gasp	negative
sensible	positive
browbeat	negative
adulate	positive
masterfully	positive
pre-eminent	positive
counter-productive	negative
hiss	negative
bewilderingly	negative
rile	negative
insightfully	positive
exceed	positive
back-logged	negative
slanderer	negative
insolently	negative
shocked	negative
low-risk	positive
best-known	positive
prudence	positive
startlingly	negative
surmount	positive
startling	negative
clean	positive
frenzy	negative
peeve	negative
tramp	negative
qualms	negative
reassurance	positive
audible	positive
acrid	negative
squeals	negative
gruff	negative
guiltily	negative
disapointing	negative
lackluster	negative
calamitous	negative
regrettably	negative
unfinished	negative
hallucinate	negative
disable	negative
ungrateful	negative
inadvisably	negative
effectively	positive
unlawfully	negative
villify	negative
well-bred	positive
sneering	negative
misguided	negative
attacks	negative
egocentric	negative
stark	negative
worthlessly	negative
dissatisfies	negative
aground	negative
robust	positive
dissenter	negative
indignity	negative
err-free	positive
comfy	positive
illusions	negative
inspiring	positive
truthfulness	positive
timidity	negative
election-rigger	negative
grotesque	negative
haywire	negative
sinfully	negative
gainfully	positive
sulk	negative
over-hyped	negative
temptation	negative
blasphemous	negative
dirtbag	negative
compactly	positive
richer	positive
beckon	positive
gullible	negative
dauntless	positive
boisterous	negative
enjoyable	positive
unrelentingly	negative
damaging	negative
weed	negative
adulterated	negative
rascal	negative
jubiliant	positive
anarchy	negative
hottest	positive
nauseates	negative
abnormal	negative
inapt	negative
nicer	positive
cautionary	negative
trustworthiness	positive
sagely	positive
exellent	positive
commendably	positive
blistering	negative
ache	negative
richness	positive
fumble	negative
bliss	positive
villianous	negative
bruises	negative
uncompromisingly	negative
miraculousness	positive
eye-catch	positive
monotony	negative
avenge	negative
rejected	negative
outburst	negative
harmless	positive
scaly	negative
enslave	negative
revelation	positive
d*mn	negative
enough	positive
temper	negative
corrupting	negative
weaken	negative
wobble	negative
empathize	positive
lukewarm	negative
desert	negative
beware	negative
stability	positive
peach	positive
frustratingly	negative
aspire	positive
gratefully	positive
lousy	negative
stain	negative
oversimplification	negative
humor	positive
aggressiveness	negative
overpriced	negative
depravedly	negative
meritorious	positive
novelty	positive
lamentably	negative
complaining	negative
crappy	negative
unbiased	positive
failing	negative
insubordinate	negative
pugnacity	negative
prodigy	positive
aggrivation	negative
clogged	negative
pitiful	negative
merrily	positive
tense	negative
exaggeration	negative
inconceivable	negative
pettifog	negative
downgrade	negative
adulation	positive
maliciously	negative
infuriated	negative
incongruous	negative
vociferously	negative
piety	positive
less-developed	negative
scum	negative
miraculous	positive
dying	negative
creep	negative
abyss	negative
exorbitantly	negative
fainthearted	negative
oversimplify	negative
detriment	negative
biased	negative
blockage	negative
great	positive
unavailable	negative
upliftingly	positive
anxieties	negative
torturous	negative
resound	positive
unconvincing	negative
lifesaver	positive
impatiently	negative
tricky	negative
passionate	positive
shortcomings	negative
burdensome	negative
undignified	negative
harbors	negative
rhetoric	negative
merciless	negative
vengeful	negative
embattled	negative
refreshing	positive
scarily	negative
head-aches	negative
amiability	positive
resilient	positive
crude	negative
unpredictable	negative
anguish	negative
aggrieved	negative
low-cost	positive
vexingly	negative
molest	negative
villains	negative
breaking	negative
spendy	negative
gainsay	negative
zealous	negative
bedlam	negative
motley	negative
barren	negative
brutally	negative
preoccupy	negative
eagerly	positive
halcyon	positive
decent	positive
uplifting	positive
niggle	negative
unqualified	negative
doom	negative
sufferer	negative
hysterically	negative
grate	negative
discriminate	negative
grieving	negative
unseemly	negative
user-replaceable	positive
brittle	negative
impress	positive
fatuity	negative
pointless	negative
2-faced	negative
contort	negative
savaged	negative
untenable	negative
ordeal	negative
impair	negative
smarter	positive
paradoxical	negative
dissocial	negative
guarantee	positive
frantic	negative
hostile	negative
unyielding	negative
bitchy	negative
ecenomical	positive
ghosting	negative
irresolute	negative
douchebags	negative
finely	positive
torture	negative
appreciated	positive
hardhearted	negative
favorable	positive
moribund	negative
erosion	negative
inelegance	negative
criticize	negative
exhaust	negative
killjoy	negative
exhilaration	positive
faith	positive
adversity	negative
whine	negative
destruction	negative
reasonably	positive
infiltrators	negative
ironies	negative
plusses	positive
accost	negative
wow	positive
sorrow	negative
frost	negative
flutter	positive
problem-free	positive
undaunted	positive
divisive	negative
passive	negative
disillusioned	negative
suffer	negative
sidetrack	negative
successful	positive
rancor	negative
revive	positive
dignified	positive
disastrously	negative
unrelenting	negative
awsome	positive
cackle	negative
slashing	negative
subjugation	negative
revitalize	positive
marvelously	positive
illegitimate	negative
jeering	negative
thumb-up	positive
conspirator	negative
delicate	positive
dead	negative
arrogant	negative
accomplished	positive
solicitously	positive
inordinately	negative
delude	negative
calumnies	negative
curse	negative
morbid	negative
stodgy	negative
titillating	positive
daunt	negative
wanton	negative
industrious	positive
respect	positive
knock	negative
embroil	negative
corrosions	negative
unwanted	negative
impossiblity	negative
hoodwink	negative
corruptted	negative
frustration	negative
intelligent	positive
defects	negative
mystify	negative
smoothest	positive
cool	positive
thrills	positive
mercilessly	negative
blundering	negative
upset	negative
enchantingly	positive
fervidly	positive
encroachment	negative
stingingly	negative
doomed	negative
conspire	negative
aborted	negative
malady	negative
downhill	negative
expropriation	negative
goon	negative
hawkish	negative
wowed	positive
undamaged	positive
burning	negative
finicky	negative
subordinate	negative
fragmented	negative
impolite	negative
painful	negative
bombard	negative
arduous	negative
contaminated	negative
wrath	negative
degradingly	negative
self-destructive	negative
asininely	negative
brute	negative
irrelevance	negative
accomodative	positive
trample	negative
illuminati	positive
morality	positive
livid	negative
stranger	negative
gratifies	positive
intrusive	negative
indiscernible	negative
imprudence	negative
alarmed	negative
rich	positive
unviewable	negative
horrific	negative
pertinacious	negative
break-ups	negative
illogic	negative
adulatory	positive
bitingly	negative
propitious	positive
distort	negative
merriness	positive
prick	negative
immaterial	negative
fluster	negative
recourses	negative
sham	negative
destains	negative
self-coup	negative
ripped	negative
ineligible	negative
glitz	positive
momentous	positive
excessively	negative
sceptical	negative
patronize	negative
deft	positive
mordant	negative
deceiver	negative
disrespectfulness	negative
hubris	negative
harmed	negative
inhumanity	negative
fearsome	negative
exuberantly	positive
demean	negative
checkered	negative
hang	negative
conflicted	negative
scratches	negative
erroneous	negative
puzzled	negative
encouragement	positive
bomb	negative
dignify	positive
misguidance	negative
polarisation	negative
ridiculous	negative
irksomeness	negative
sullen	negative
hairloss	negative
mirage	negative
undone	negative
mad	negative
pillage	negative
demonizes	negative
utterly	negative
sneaky	negative
opponent	negative
pretence	negative
revulsion	negative
forbidding	negative
deceive	negative
polution	negative
banal	negative
irritably	negative
disintegrated	negative
mudslinging	negative
collapse	negative
angriness	negative
cheater	negative
happier	positive
spoilled	negative
criticisms	negative
insubstantially	negative
insolent	negative
pratfall	negative
cons	negative
effectiveness	positive
dizzy	negative
slander	negative
lower-priced	positive
acrimonious	negative
jutter	negative
mercifully	positive
disgust	negative
passiveness	negative
radicalization	negative
crumbling	negative
inconsolably	negative
affront	negative
sore	negative
finagle	negative
goodness	positive
idiots	negative
expropriate	negative
smouldering	negative
lambast	negative
geekier	positive
wildly	negative
extortion	negative
murky	negative
badly	negative
jealously	negative
laconic	negative
gallant	positive
lethargic	negative
unstable	negative
pedantic	negative
gain	positive
violation	negative
clearly	positive
lure	negative
excitedly	positive
dented	negative
persevere	positive
marvel	positive
senselessly	negative
fail	negative
irrecoverablenesses	negative
inconsequential	negative
recession	negative
humble	positive
supports	positive
dispensable	negative
pleasantly	positive
indulgence	positive
fruitful	positive
attack	negative
overdo	negative
best-performing	positive
scuffs	negative
jeeringly	negative
distract	negative
straggler	negative
smack	negative
banalize	negative
modesty	positive
gracefully	positive
languid	negative
downfallen	negative
disaffected	negative
quarrelsome	negative
omit	negative
enviousness	negative
misstatement	negative
peculiarly	negative
delight	positive
commotions	negative
justly	positive
whining	negative
lag	negative
elate	positive
flawlessly	positive
flaunt	negative
condescension	negative
hatred	negative
obnoxious	negative
fascinating	positive
profanity	negative
contrasty	positive
rude	negative
torment	negative
threats	negative
joyously	positive
sharply	negative
humane	positive
warned	negative
awe	positive
entrapment	negative
dark	negative
secretive	negative
sensation	positive
smoke	negative
scandalously	negative
insular	negative
sufficient	positive
scorn	negative
chilly	negative
complements	positive
gems	positive
dullard	negative
fairness	positive
considerate	positive
hooligan	negative
mindless	negative
dearth	negative
exhilarating	positive
devout	positive
blotchy	negative
dirt	negative
cure-all	positive
deign	negative
imposers	negative
liberate	positive
conspiratorial	negative
record-setting	positive
rock-star	positive
aggravating	negative
bellicose	negative
evil	negative
creepy	negative
mawkishness	negative
disintegrates	negative
restructuring	positive
properly	positive
alarmingly	negative
attractively	positive
courageous	positive
happily	positive
eyecatching	positive
amazement	positive
ovation	positive
absurdly	negative
flattering	positive
disagreeable	negative
glimmering	positive
fiasco	negative
denunciation	negative
saint	positive
anti-semites	negative
hurtful	negative
well-intentioned	positive
anti-american	negative
beg	negative
fateful	negative
impudently	negative
floundering	negative
enraged	negative
dissatisfactory	negative
reluctance	negative
desertion	negative
unreachable	negative
exclusion	negative
angry	negative
virulence	negative
unquestionably	positive
faultless	positive
scathingly	negative
lecherous	negative
neat	positive
aimless	negative
contaminates	negative
majesty	positive
simplistically	negative
uncreative	negative
bewilderment	negative
bugging	negative
blame	negative
spitefulness	negative
deluge	negative
shortsighted	negative
stubbornness	negative
apprehensively	negative
fanatical	negative
quiet	positive
tops	positive
talented	positive
politeness	positive
mesmerized	positive
disabled	negative
mortifying	negative
impure	negative
suspect	negative
exceled	positive
enfeeble	negative
despondence	negative
hideously	negative
pale	negative
coerce	negative
fatique	negative
reject	negative
mendacious	negative
calumniously	negative
unwieldy	negative
problems	negative
mist	negative
slammin	positive
pugnacious	negative
harshly	negative
lechery	negative
assail	negative
supremacy	positive
ingrate	negative
enjoyed	positive
bafflement	negative
felicitate	positive
unravel	negative
phenomenally	positive
qualm	negative
fast-paced	positive
gratification	positive
cheats	negative
despotic	negative
scandalize	negative
altercation	negative
rejecting	negative
god-given	positive
rightly	positive
outsider	negative
exemplar	positive
attune	positive
inarticulate	negative
aversion	negative
quarrellously	negative
monster	negative
insidiously	negative
celebrated	positive
leaky	negative
brimstone	negative
anxiously	negative
apocalypse	negative
glamorous	positive
logical	positive
nastiness	negative
hardliners	negative
scarce	negative
bleak	negative
critic	negative
suspicions	negative
reverently	positive
panic	negative
conceit	negative
anger	negative
heroize	positive
profoundly	positive
capitulate	negative
enrapt	positive
resounding	positive
exceeds	positive
spiritual	positive
weaknesses	negative
regret	negative
misalign	negative
instigator	negative
detract	negative
pain	negative
mighty	positive
enjoy	positive
rampage	negative
banishment	negative
fancier	positive
irrelevant	negative
scummy	negative
nervously	negative
ingenuity	positive
miser	negative
wrip	negative
severity	negative
immoderate	negative
reprimand	negative
mockingly	negative
2-faces	negative
numb	negative
glowing	positive
envious	negative
educated	positive
prosperous	positive
welcome	positive
debase	negative
dense	negative
mists	negative
steep	negative
twist	negative
tough	positive
pepped	positive
fatally	negative
fearfully	negative
majestic	positive
personalized	positive
seethe	negative
worthwhile	positive
cannibalize	negative
unbearablely	negative
infuriatingly	negative
disrespectful	negative
rape	negative
obstructing	negative
domineering	negative
bluring	negative
fierce	negative
bully	negative
bull----	negative
ho-hum	negative
fugitive	negative
jealousy	negative
enviously	negative
efficacious	positive
brainless	negative
fraudulent	negative
alienation	negative
nasty	negative
opposition	negative
refund	positive
dote	positive
regretted	negative
rough	negative
regress	negative
unbearable	negative
importunate	negative
isolated	negative
trauma	negative
genocide	negative
fathomless	negative
indifference	negative
villainous	negative
handy	positive
earsplitting	negative
unfairly	negative
softer	positive
obstacle	negative
defunct	negative
shadowy	negative
sad	negative
damage	negative
painfull	negative
recommendations	positive
hassles	negative
teasingly	negative
law-abiding	positive
prudent	positive
graciously	positive
generous	positive
indoctrinate	negative
sueing	negative
treasonous	negative
dubitable	negative
calumniation	negative
recommendation	positive
praise	positive
euphoria	positive
appallingly	negative
rife	negative
unusably	negative
bullies	negative
fictitious	negative
chaotic	negative
unavoidably	negative
invaluable	positive
confounding	negative
invigorate	positive
prestige	positive
remedy	positive
capably	positive
enhancement	positive
comfortably	positive
whore	negative
toll	negative
enviably	positive
ill-used	negative
bereft	negative
gaiety	positive
unfriendly	negative
imperfections	negative
frustrations	negative
inglorious	negative
mourner	negative
tamper	negative
inappropriately	negative
nastily	negative
intense	negative
accurately	positive
bereavement	negative
rival	negative
uncertain	negative
detachable	positive
liable	negative
gauche	negative
parody	negative
bothersome	negative
sublime	positive
inexpensive	positive
maddening	negative
instigate	negative
exhilaratingly	positive
astonish	positive
homage	positive
insane	negative
mope	negative
annoyances	negative
deficiencies	negative
gifted	positive
intractable	negative
misdirection	negative
wreaks	negative
reprove	negative
rumbling	negative
hardy	positive
gimmicking	negative
chronic	negative
excellent	positive
crisper	positive
inclement	negative
emaciated	negative
mischief	negative
ranting	negative
smugly	negative
gainsayer	negative
enchant	positive
godlike	positive
fashionably	positive
difficulties	negative
advocated	positive
joker	negative
infected	negative
demoralizingly	negative
frail	negative
demeaning	negative
durable	positive
amuse	positive
self-interested	negative
belabor	negative
undercuts	negative
junkyard	negative
resentful	negative
inconsiderately	negative
repulsively	negative
rebuff	negative
annihilate	negative
bitterly	negative
stern	negative
disliking	negative
recovery	positive
rail	negative
quack	negative
licentious	negative
bulkier	negative
strict	negative
antagonize	negative
haste	negative
goodwill	positive
marvelousness	positive
meaningless	negative
stable	positive
illustrious	positive
ignoble	negative
petrify	negative
sensationalize	negative
uncouth	negative
disavow	negative
worrier	negative
blunder	negative
dishonesty	negative
vengefulness	negative
self-satisfaction	positive
stalemate	negative
faithless	negative
fawningly	negative
rumors	negative
workable	positive
excites	positive
reluctant	negative
complains	negative
helped	positive
perseverance	positive
hampered	negative
destiny	positive
nightmare	negative
paranoia	negative
mishap	negative
rapport	positive
indignantly	negative
instrumental	positive
selfinterested	negative
proactive	positive
disturbance	negative
irrationalities	negative
violator	negative
slogging	negative
supremely	positive
rightness	positive
undermining	negative
precise	positive
deserving	positive
misses	negative
depressed	negative
inescapably	negative
drawback	negative
freaking	negative
liars	negative
innuendo	negative
blow	negative
redundancy	negative
resignation	negative
grumpiest	negative
proven	positive
spellbinding	positive
high-quality	positive
noise	negative
upheld	positive
freakishly	negative
freedoms	positive
superstitious	negative
admonish	negative
devastated	negative
eyecatch	positive
drop-outs	negative
hangs	negative
reclaim	positive
heros	positive
uneconomical	negative
fastest	positive
futility	negative
harmony	positive
prospros	positive
hard-hit	negative
wail	negative
dishonorable	negative
disrespecting	negative
invalidity	negative
demolish	negative
iniquity	negative
dunce	negative
eased	positive
hamper	negative
diligent	positive
confrontational	negative
cussed	negative
obnoxiously	negative
tetchily	negative
acclaimed	positive
scuff	negative
uncompromising	negative
slowest	negative
revere	positive
flares	negative
dusty	negative
carnage	negative
scramble	negative
state-of-the-art	positive
scarier	negative
long-lasting	positive
phobic	negative
nifty	positive
truthfully	positive
luster	positive
sane	positive
indigent	negative
astray	negative
fumes	negative
misjudgment	negative
relent	positive
irregularity	negative
hegemonism	negative
madder	negative
worthiness	positive
optimistic	positive
defect	negative
insignificantly	negative
taboo	negative
discontinuous	negative
droop	negative
ameliorate	positive
flareups	negative
abolish	negative
detracting	negative
incredulously	negative
infallibility	positive
irreformable	negative
flourishing	positive
straggle	negative
ill-treated	negative
weaker	negative
frugal	positive
acclamation	positive
besmirch	negative
plotters	negative
wrinkle	negative
flighty	negative
overacted	negative
challenging	negative
mock	negative
raving	negative
mistaken	negative
famished	negative
endorsing	positive
cruelty	negative
arcane	negative
comical	negative
hoard	negative
appreciates	positive
sumptuous	positive
success	positive
crueler	negative
dreadful	negative
unproven	negative
undercut	negative
toxic	negative
enchanted	positive
mindlessly	negative
low-rated	negative
inevitably	negative
negativity	negative
congratulations	positive
gorgeously	positive
vestiges	negative
uproot	negative
unresolved	negative
cruel	negative
confound	negative
grateful	positive
squander	negative
prolific	positive
shamelessness	negative
loss	negative
rhapsodize	negative
idol	positive
flake	negative
spewing	negative
patriot	positive
wonderous	positive
triumph	positive
gaudy	negative
grumpily	negative
troubled	negative
joyful	positive
wobbled	negative
weakening	negative
reprehensive	negative
idle	negative
jubilate	positive
sparkle	positive
best	positive
benevolent	positive
deplete	negative
disquiet	negative
arduously	negative
insultingly	negative
abruptly	negative
spurious	negative
downside	negative
bowdlerize	negative
disinterested	negative
dismissive	negative
idiotic	negative
dismayingly	negative
maturity	positive
unnoticed	negative
hatefulness	negative
won	positive
overstatement	negative
critics	negative
austere	negative
orphan	negative
disapointment	negative
invulnerable	positive
calamity	negative
resourceful	positive
subsidize	positive
scams	negative
emphatic	negative
upheaval	negative
inhibit	negative
disconcertingly	negative
gleefully	positive
besiege	negative
alienated	negative
exaltedly	positive
overtaken	positive
nonexistent	negative
atrocities	negative
proficiently	positive
misunderstood	negative
dispiriting	negative
unimaginably	negative
instigators	negative
cleared	positive
arbitrary	negative
pigs	negative
diametrically	negative
snobs	negative
serenity	positive
smolder	negative
fascist	negative
debauch	negative
freshest	positive
mobster	negative
petty	negative
impotent	negative
cripples	negative
despairing	negative
winners	positive
dirtbags	negative
leverage	positive
engaging	positive
lorn	negative
balk	negative
lapses	negative
stagnation	negative
incomplete	negative
inspirational	positive
traped	negative
smug	negative
grouchy	negative
admirable	positive
shiver	negative
unlucky	negative
abuse	negative
catchy	positive
miserably	negative
unsettled	negative
clique	negative
clamor	negative
quicker	positive
purposeful	positive
excite	positive
longing	negative
gooood	positive
doubtful	negative
personages	positive
disses	negative
freezes	negative
absence	negative
terror	negative
unsuspecting	negative
tenuously	negative
disorder	negative
notoriety	negative
inordinate	negative
positives	positive
handsome	positive
ftw	positive
dinky	negative
galls	negative
woe	negative
impersonal	negative
decrepit	negative
beautifully	positive
beauty	positive
excellence	positive
exacerbate	negative
forgetfully	negative
blurring	negative
bungle	negative
exagerated	negative
stifle	negative
rightfully	positive
swindle	negative
agonizingly	negative
downer	negative
agilely	positive
dishearteningly	negative
barbarian	negative
shocking	negative
penalty	negative
scant	negative
racy	negative
guidance	positive
hazard	negative
mendacity	negative
damn	negative
well-known	positive
usable	positive
upgradeable	positive
drop-out	negative
rollercoaster	negative
unlicensed	negative
mawkish	negative
unsettling	negative
remunerate	positive
obscenity	negative
omission	negative
invincibility	positive
hysteric	negative
erase	negative
bemused	negative
self-sufficient	positive
dubiously	negative
ill-mannered	negative
unrestricted	positive
nebulous	negative
simplest	positive
muddy	negative
despoil	negative
so-cal	negative
cherished	positive
well-being	positive
elimination	negative
dissuade	negative
ruffian	negative
improvements	positive
sensations	positive
taunting	negative
improperly	negative
thrill	positive
soulful	positive
cringes	negative
rascals	negative
well-run	positive
rectify	positive
capability	positive
overwhelm	negative
oppression	negative
submissive	negative
bust	negative
hypocricy	negative
disobedience	negative
unacceptablely	negative
rapturous	positive
refusing	negative
amazes	positive
thoughtfully	positive
self-criticism	negative
recover	positive
guiltless	positive
enraging	negative
influential	positive
worsening	negative
extinguish	negative
cleanest	positive
mature	positive
smear	negative
trendy	positive
smartly	positive
gaily	positive
stellar	positive
lurk	negative
sarcastic	negative
irascible	negative
untruthful	negative
youthful	positive
miracle	positive
wayward	negative
darken	negative
mislead	negative
beguile	negative
faze	negative
leaks	negative
fissures	negative
heal	positive
prideful	negative
ruthless	negative
halfheartedly	negative
foully	negative
malcontented	negative
restructured	positive
sputter	negative
awarded	positive
felicitous	positive
noises	negative
baffled	negative
bothers	negative
urgent	negative
discrepant	negative
antagonism	negative
mistrust	negative
afflict	negative
disputed	negative
shatter	negative
polluters	negative
deterrent	negative
tempting	positive
consistently	positive
fervid	positive
bicker	negative
renunciation	negative
unsteadiness	negative
gratitude	positive
exhaustion	negative
combust	negative
statuesque	positive
wilt	negative
outlaw	negative
problematic	negative
eloquence	positive
rash	negative
debatable	negative
intelligible	positive
available	positive
sloww	negative
reform	positive
haggard	negative
bleed	negative
bash	negative
horrendously	negative
realistic	positive
sass	negative
friction	negative
ludicrous	negative
condemns	negative
self-respect	positive
misfortune	negative
creak	negative
blurs	negative
cheerless	negative
villainously	negative
savior	positive
sticky	negative
famous	positive
unreliability	negative
harden	negative
damnation	negative
motivated	positive
brainwash	negative
untouched	negative
screwed	negative
plea	negative
ugliest	negative
capriciously	negative
hefty	negative
entertain	positive
haphazard	negative
twists	negative
seriousness	negative
dismissively	negative
gleeful	positive
misbehave	negative
cheery	positive
intolerablely	negative
rapid	positive
irregular	negative
grating	negative
limp	negative
astonishing	positive
savages	negative
delusions	negative
overtaking	positive
perversely	negative
leakages	negative
jitter	negative
asperse	negative
enlightenment	positive
notorious	negative
glorious	positive
intolerance	negative
ambitiously	positive
embarrass	negative
mangle	negative
grin	positive
righteousness	positive
deficiency	negative
convincing	positive
sumptuousness	positive
boastful	negative
hasty	negative
censure	negative
empower	positive
ironical	negative
grisly	negative
unrealistic	negative
uneventful	negative
fortunate	positive
violate	negative
soft	positive
inconsequentially	negative
flout	negative
immorality	negative
adversarial	negative
picket	negative
maneuverable	positive
leading	positive
pompous	negative
butcher	negative
likes	positive
confounded	negative
friendly	positive
slaughtered	negative
drab	negative
flakieness	negative
effectual	positive
fleer	negative
subjugate	negative
paltry	negative
heavy-handed	negative
cherish	positive
furor	negative
sloooooooooooooow	negative
attractive	positive
water-down	negative
delinquency	negative
empowerment	positive
vexation	negative
flicering	negative
caustically	negative
openly	positive
smother	negative
thorny	negative
ignorance	negative
vulnerable	negative
appreciative	positive
progress	positive
sexy	positive
false	negative
stainless	positive
ineptly	negative
misinformed	negative
miscreant	negative
toil	negative
obscured	negative
infiltrator	negative
preferable	positive
inconveniently	negative
ultimatum	negative
moody	negative
fret	negative
disadvantage	negative
quitter	negative
corrupted	negative
foreboding	negative
dumbfounded	positive
ecstatic	positive
wrongly	negative
delusion	negative
euphorically	positive
ravage	negative
leak	negative
carp	negative
remorsefully	negative
marvelled	positive
apathetically	negative
farcical-yet-provocative	negative
accuses	negative
wickedness	negative
pitifully	negative
biases	negative
mysterious	negative
extravagantly	negative
marveled	positive
declaim	negative
chore	negative
skeletons	negative
extremists	negative
dreamland	positive
jolly	positive
flagrant	negative
fussy	negative
awfully	negative
infection	negative
outdo	positive
shrilly	negative
wobbles	negative
rue	negative
ding	negative
flirty	negative
gloom	negative
scream	negative
meticulous	positive
screw-up	negative
harboring	negative
fondness	positive
darkened	negative
unsteadily	negative
ranted	negative
hater	negative
stylish	positive
revengeful	negative
calumny	negative
goad	negative
malice	negative
wisdom	positive
insightful	positive
unprofitable	negative
hating	negative
disservice	negative
accolade	positive
fallacies	negative
misbecoming	negative
far-fetched	negative
champion	positive
superiority	positive
overlook	negative
pampered	positive
stylized	positive
slur	negative
cheaper	positive
scratch	negative
thrift	positive
repudiation	negative
useless	negative
fanfare	positive
stridently	negative
awkwardness	negative
recomend	positive
doubts	negative
ardent	positive
amiss	negative
inflationary	negative
fallaciously	negative
balanced	positive
unfavorable	negative
worries	negative
fatigue	negative
substantive	positive
kooky	negative
intermittent	negative
dissension	negative
fleeing	negative
estranged	negative
rotten	negative
impermissible	negative
radically	negative
tired	negative
distastefully	negative
misgiving	negative
snagged	negative
examplar	positive
hearten	positive
confined	negative
severe	negative
cloudy	negative
confuses	negative
humiliation	negative
furiously	negative
ridicule	negative
immovable	negative
honored	positive
indiscriminately	negative
fallout	negative
exult	positive
drags	negative
belittled	negative
forswear	negative
faithful	positive
lose	negative
scorching	negative
avidly	positive
shriek	negative
syndrome	negative
favor	positive
condemnable	negative
cynical	negative
excuses	negative
feverish	negative
intolerable	negative
lavishly	positive
annoying	negative
fevers	negative
flair	negative
dumping	negative
illogically	negative
stereotypical	negative
pessimistic	negative
outraged	negative
disrespectfully	negative
ignominious	negative
fascism	negative
vindictive	negative
gripes	negative
supple	positive
stunningly	positive
safely	positive
absurdness	negative
preferes	positive
undue	negative
soreness	negative
believable	positive
flatter	positive
articulate	positive
bugs	negative
forbidden	negative
eccentric	negative
lags	negative
steeply	negative
resolute	positive
bores	negative
break-up	negative
steadfastly	positive
overwhelmed	negative
reputable	positive
regression	negative
squeaky	negative
rapturously	positive
consummate	positive
precariously	negative
reaffirm	positive
thrive	positive
hype	negative
trusty	positive
cataclysmically	negative
exceedingly	positive
immodest	negative
bastards	negative
unsuccessfully	negative
flagging	negative
supporter	positive
magnificence	positive
stumbles	negative
wicked	negative
keenly	positive
enticingly	positive
ill-formed	negative
forbid	negative
accomplishments	positive
smelled	negative
grim	negative
ironically	negative
bewildering	negative
adamantly	negative
crushed	negative
equivocal	negative
scapegoat	negative
illusory	negative
excuse	negative
backache	negative
skittishly	negative
invidious	negative
disastrous	negative
ingratitude	negative
accusations	negative
chastise	negative
simpler	positive
wholeheartedly	positive
whoa	positive
shamefully	negative
insufferable	negative
lagged	negative
impugn	negative
deploringly	negative
stammer	negative
prodigious	positive
superfluous	negative
enhance	positive
unsupported	negative
corrode	negative
nepotism	negative
catastrophes	negative
fear	negative
congested	negative
licentiousness	negative
collusion	negative
ambiguous	negative
unforgiving	negative
unwatchable	negative
praiseworthy	positive
jeopardy	negative
mangling	negative
commonplace	negative
transgress	negative
sneak	negative
falter	negative
freeze	negative
slug	negative
lethal	negative
dazzled	positive
impolitely	negative
heartbreakingly	negative
lull	negative
work	positive
rejoicing	positive
procrastination	negative
miseries	negative
luxury	positive
sinisterly	negative
glibly	negative
indecision	negative
blinding	negative
heckles	negative
joke	negative
meltdown	negative
efficient	positive
recessionary	negative
myth	negative
outshine	positive
bumpy	negative
damper	negative
blister	negative
darling	positive
incorrigible	negative
tragically	negative
froze	negative
lustrous	positive
delightfully	positive
inane	negative
illiterate	negative
supurb	positive
sickly	negative
chunky	negative
outbreak	negative
job-killing	negative
flare	negative
trust	positive
calamitously	negative
thoughtless	negative
slick	positive
insensitively	negative
confusions	negative
stupidly	negative
queer	negative
complained	negative
scrambled	negative
effigy	negative
inattentive	negative
boom	positive
grind	negative
improbably	negative
sicken	negative
hinder	negative
evenly	positive
isolation	negative
bs	negative
abscond	negative
subversive	negative
murderously	negative
extremism	negative
excallent	positive
inexcusably	negative
cravenly	negative
dirts	negative
stifling	negative
complain	negative
snarky	negative
profuse	positive
pros	positive
uncaring	negative
facetious	negative
shrill	negative
imprisonment	negative
bewitch	negative
contamination	negative
ruined	negative
golden	positive
irreversible	negative
time-honored	positive
accusingly	negative
insinuating	negative
sweetly	positive
jealous	negative
maniac	negative
radiant	positive
intimidate	negative
crooked	negative
tawdry	negative
impressiveness	positive
continuity	positive
coward	negative
nice	positive
dismalness	negative
bereave	negative
blatantly	negative
anxious	negative
wrought	negative
halfhearted	negative
amazed	positive
celebrate	positive
harangue	negative
warning	negative
doldrums	negative
beneficent	positive
dissembler	negative
fuzzy	negative
excellently	positive
graceful	positive
galore	positive
hissing	negative
denunciate	negative
two-faces	negative
openness	positive
transparent	positive
reliable	positive
picketed	negative
lies	negative
burn	negative
wince	negative
well-made	positive
sleek	positive
cataclysmal	negative
undid	negative
grievances	negative
abysmally	negative
expunge	negative
backwoods	negative
unconstitutional	negative
drastic	negative
last-ditch	negative
sleazy	negative
broke	negative
static	negative
incredible	positive
turmoil	negative
juddering	negative
deploring	negative
neatly	positive
nervousness	negative
god-send	positive
inadverent	negative
pander	negative
concession	negative
misapprehend	negative
lewd	negative
scary	negative
indecent	negative
bankrupt	negative
stereotypically	negative
ailing	negative
malicious	negative
wary	negative
long-winded	negative
ludicrously	negative
uninsured	negative
futile	negative
distortion	negative
tetchy	negative
screwed-up	negative
hypocritical	negative
desiccate	negative
subservience	negative
forged	negative
lighter	positive
merry	positive
little-known	negative
genial	positive
flirt	negative
unimaginable	negative
fiendish	negative
lovelorn	negative
sully	negative
beckons	positive
filth	negative
festive	positive
brutalizing	negative
tank	negative
revenge	negative
growl	negative
wisely	positive
unfazed	positive
aloof	negative
tranquility	positive
adoringly	positive
holy	positive
worryingly	negative
loving	positive
crash	negative
obsolete	negative
ugh	negative
appreciate	positive
strut	negative
preferring	positive
dies	negative
delusional	negative
twinkly	positive
diss	negative
battered	negative
readily	positive
unrivaled	positive
decadent	negative
easygoing	positive
unachievable	negative
disrupt	negative
frown	negative
sensational	positive
raptureously	positive
eschew	negative
loophole	negative
occludes	negative
scandalous	negative
retreat	negative
pleas	negative
impious	negative
premeditated	negative
maledict	negative
inferiority	negative
upgradable	positive
errant	negative
disbeliever	negative
wheedle	negative
fatalistic	negative
brazenly	negative
edify	positive
perverted	negative
dissatisfying	negative
humiliate	negative
reward	positive
bravo	positive
obscure	negative
inextricable	negative
accessable	positive
unmatched	positive
bloodshed	negative
cocky	negative
avarice	negative
raptureous	positive
coherence	positive
cranky	negative
straighten	positive
overstate	negative
clever	positive
wrest	negative
shabby	negative
bondage	negative
unwisely	negative
surpass	positive
wild	negative
irrationals	negative
perturbed	negative
bountiful	positive
inconsolable	negative
wise	positive
shaky	negative
escapade	negative
overture	positive
limits	negative
sarcasm	negative
securely	positive
exasperate	negative
destitution	negative
objectionable	negative
autocratic	negative
quaint	positive
avaricious	negative
grace	positive
worrying	negative
lucid	positive
irksome	negative
cheesy	negative
impossible	negative
inconstant	negative
undercutting	negative
comfort	positive
infallible	positive
inequitable	negative
insurrection	negative
deaf	negative
lovely	positive
excels	positive
brainiest	positive
licentiously	negative
infringements	negative
disingenuously	negative
depressing	negative
limitation	negative
illuminating	positive
revolt	negative
impasse	negative
laud	positive
gladness	positive
blunt	negative
resplendent	positive
buckle	negative
wonderfully	positive
luxurious	positive
stereotype	negative
imprecisely	negative
harmoniously	positive
overplay	negative
proficient	positive
repugnantly	negative
playfully	positive
defeats	positive
punishable	negative
demonic	negative
irksomely	negative
swanky	positive
expertly	positive
beneficiary	positive
injure	negative
lawfully	positive
exorbitantance	negative
monstrosities	negative
famously	positive
struck	negative
inoperable	negative
unclear	negative
condemn	negative
empathy	positive
travesty	negative
admonishment	negative
vilify	negative
paralyzed	negative
disillusions	negative
incivility	negative
outcast	negative
adroit	positive
dissident	negative
bolster	positive
suspicion	negative
adored	positive
snag	negative
effusiveness	positive
win	positive
grievance	negative
creative	positive
cunt	negative
adoring	positive
tanked	negative
unjustified	negative
confuse	negative
loopholes	negative
heathen	negative
angel	positive
delirium	negative
jerky	negative
unexplained	negative
abrade	negative
polished	positive
affluent	positive
terrorism	negative
lackeys	negative
bleeds	negative
revel	positive
sluggish	negative
tenacity	positive
ominous	negative
supportive	positive
ingenuous	positive
nefarious	negative
passionately	positive
spectacular	positive
easy	positive
thumbs-down	negative
excited	positive
ingenious	positive
sweeten	positive
virtuous	positive
support	positive
threaten	negative
respectfully	positive
accessible	positive
partisans	negative
dents	negative
renounce	negative
crashed	negative
trouble-free	positive
swagger	negative
conflict	negative
diligently	positive
hard-line	negative
dumbfounding	positive
misbegotten	negative
squeaks	negative
exultation	positive
decadence	negative
deceitfully	negative
setbacks	negative
ideal	positive
indistinguishable	negative
anti-occupation	negative
alienate	negative
trivial	negative
fragile	negative
incoherence	negative
mislike	negative
strongest	positive
overturn	negative
stinging	negative
miscreants	negative
dictator	negative
acerbate	negative
contaminating	negative
grumpier	negative
regal	positive
despised	negative
succes	positive
vivacious	positive
delectable	positive
freezing	negative
overdone	negative
crazy	negative
apologists	negative
attraction	positive
adaptable	positive
distinction	positive
plush	positive
congratulate	positive
antiquated	negative
well-wishers	positive
disinterest	negative
implode	negative
satirize	negative
overthrow	negative
outstandingly	positive
intelligence	positive
expel	negative
disloyalty	negative
beauteous	positive
smokescreen	negative
exhort	negative
spiteful	negative
endorsement	positive
squabbling	negative
relentlessly	negative
stunning	positive
hostility	negative
comprehensive	positive
imposing	negative
farcical	negative
enthrall	positive
devastates	negative
extravagant	negative
undermined	negative
infidel	negative
emphatically	negative
adorer	positive
venomously	negative
wack	negative
bruised	negative
suffices	positive
mispronounce	negative
idealize	positive
revulsive	negative
like	positive
unusually	negative
feisty	positive
luxuriate	positive
advantage	positive
brightest	positive
drawbacks	negative
qualify	positive
sick	negative
hegemonistic	negative
colorful	positive
misaligned	negative
coherent	positive
jeer	negative
ruthlessly	negative
successfully	positive
fault	negative
invalid	negative
faithfulness	positive
disorganized	negative
callous	negative
inspiration	positive
pathetically	negative
impedance	negative
unskilled	negative
sagging	negative
spacious	positive
hurt	negative
stiffness	negative
sloppy	negative
stole	negative
disintegrate	negative
deluded	negative
rampant	negative
irrationality	negative
greasy	negative
terrorize	negative
misread	negative
humming	negative
reticent	negative
fearful	negative
infuriate	negative
weary	negative
tender	positive
uglier	negative
assure	positive
scarred	negative
unforgettable	positive
boredom	negative
treachery	negative
leery	negative
distains	negative
delaying	negative
marginal	negative
stumps	negative
scourge	negative
glowingly	positive
backwood	negative
sober	negative
dishonestly	negative
tyrannically	negative
supurbly	positive
strictly	negative
jollify	positive
foul	negative
decisive	positive
distressingly	negative
conspiracies	negative
peaceful	positive
unuseably	negative
scrambles	negative
failed	negative
incredibly	positive
sweaty	negative
abysmal	negative
acclaim	positive
enjoyment	positive
hopelessly	negative
atrophy	negative
acridly	negative
decrepitude	negative
irresolvable	negative
dreadfully	negative
buzzing	negative
unlamentably	negative
punch	negative
subsidizing	positive
nimble	positive
vile	negative
terribly	negative
reprovingly	negative
dissidence	negative
alluringly	positive
daunting	negative
imminently	negative
glad	positive
geeky	positive
impediment	negative
healthy	positive
smoldering	negative
crisp	positive
swamped	negative
exaltingly	positive
dotingly	positive
cheerful	positive
protesting	negative
foe	negative
creaks	negative
disagreement	negative
tentatively	negative
annoyed	negative
dispiritedly	negative
well-educated	positive
contrived	negative
bumps	negative
fantastically	positive
suicidal	negative
irrecoverableness	negative
glitch	negative
easier	positive
dissuasive	negative
wrinkled	negative
classic	positive
disgraceful	negative
wiles	negative
fake	negative
abuses	negative
lurking	negative
profound	positive
affable	positive
undisputably	positive
vouch	positive
hassled	negative
deviate	negative
enraptured	positive
pestilent	negative
lame-duck	negative
sillily	negative
prefered	positive
hoodium	negative
aggrieve	negative
unilateralism	negative
rigid	negative
panicked	negative
merriment	positive
convienient	positive
slumping	negative
choke	negative
contribution	positive
affection	positive
belittle	negative
timid	negative
pitilessly	negative
dogmatic	negative
gladden	positive
uprising	negative
inconsistencies	negative
sucks	negative
cleaner	positive
readable	positive
casualty	negative
subvert	negative
ripoff	negative
subversion	negative
sensitive	positive
oversimplified	negative
inimically	negative
impressive	positive
glorify	positive
worn	negative
unnaturally	negative
distrustful	negative
derisive	negative
exultingly	positive
bored	negative
prestigious	positive
slowed	negative
disloyal	negative
vehemently	negative
humid	negative
deviously	negative
panicky	negative
inflammation	negative
disdain	negative
vigilance	positive
anti-proliferation	negative
wedge	negative
warmly	positive
complex	negative
extoll	positive
stylishly	positive
pokey	negative
monstrous	negative
bullying	negative
lack	negative
disturb	negative
awful	negative
tepid	negative
derisively	negative
ragged	negative
ilu	positive
astonished	positive
proves	positive
expulse	negative
counter-attacks	positive
effortless	positive
ire	negative
charm	positive
imperfection	negative
preposterously	negative
topple	negative
amenity	positive
criticizing	negative
inhospitality	negative
crime	negative
vehement	negative
fidget	negative
turbulent	negative
fulfillment	positive
perfection	positive
sardonically	negative
magical	positive
perplexity	negative
infections	negative
clear-cut	positive
blasted	negative
drought	negative
muddle	negative
anarchist	negative
dilapidated	negative
grapple	negative
dissonance	negative
stumble	negative
dim	negative
outrageousness	negative
awkward	negative
revoltingly	negative
retard	negative
discredit	negative
prefer	positive
inadequately	negative
propagandize	negative
vengefully	negative
subdued	negative
slut	negative
bastard	negative
zap	negative
perplexed	negative
graceless	negative
malcontent	negative
sincerely	positive
tardy	negative
indecency	negative
disgruntled	negative
insociable	negative
protective	positive
maliciousness	negative
daringly	positive
rumours	negative
tiring	negative
astoundingly	positive
ugliness	negative
comfortable	positive
captivate	positive
obstinately	negative
delayed	negative
courageousness	positive
defiance	negative
unlikely	negative
inadequacy	negative
capricious	negative
lawful	positive
disquieting	negative
regard	positive
courage	positive
unthinkably	negative
unequivocal	positive
defame	negative
stinks	negative
indefensible	negative
slave	negative
eyesore	negative
contradict	negative
stall	negative
self-humiliation	negative
outrageous	negative
repulsing	negative
betrayals	negative
presumptuous	negative
warlike	negative
heartbreaking	negative
integrated	positive
famed	positive
dripped	negative
dissent	negative
cunts	negative
famine	negative
suicide	negative
abrasive	negative
abominable	negative
regretful	negative
overbearing	negative
laughably	negative
stellarly	positive
roomy	positive
suspicious	negative
inveigle	negative
unlamentable	negative
grand	positive
splendidly	positive
batty	negative
sustainability	positive
respectful	positive
wasteful	negative
energize	positive
infamy	negative
brat	negative
lurch	negative
setback	negative
evasive	negative
misgivings	negative
jaundiced	negative
startle	negative
crashing	negative
dissonant	negative
fallacious	negative
sanctimonious	negative
deginified	positive
breach	negative
failure	negative
perturb	negative
chivalrous	positive
fastuous	negative
atrocious	negative
magnanimous	positive
extremist	negative
tumbled	negative
floored	negative
fat-cats	negative
profane	negative
addict	negative
flak	negative
inexperience	negative
fatal	negative
feint	negative
worthy	positive
oppress	negative
f**k	negative
egotism	negative
unjustifiably	negative
excruciating	negative
raked	negative
hindrance	negative
breakthrough	positive
insecure	negative
dissention	negative
dominate	positive
scorchingly	negative
concens	negative
unbelievable	negative
wreck	negative
pessimism	negative
better-known	positive
glimmer	positive
occluded	negative
infallibly	positive
intimidating	negative
heretical	negative
cursed	negative
obsessive	negative
gibe	negative
overrun	negative
conservative	negative
inflame	negative
contemptible	negative
imperious	negative
back-wood	negative
impenitent	negative
scam	negative
issues	negative
heaven	positive
vibrated	negative
inexperienced	negative
immature	negative
overtook	positive
stupified	negative
trustingly	positive
clarity	positive
misbecome	negative
skimpy	negative
winner	positive
beautiful	positive
offenses	negative
zealot	negative
jaded	negative
effortlessly	positive
spotty	negative
dead-cheap	positive
tantalizing	positive
gross	negative
died	negative
undisputable	positive
cracked	negative
uneasy	negative
sucky	negative
hot	positive
unleash	negative
hospitable	positive
inaccuracy	negative
profusion	positive
fabrication	negative
fresh	positive
repulsed	negative
trumpet	positive
liberation	positive
cooperatively	positive
spitefully	negative
clash	negative
comely	positive
brilliant	positive
mistress	negative
eviscerate	negative
restrict	negative
outperformed	positive
depraved	negative
thumb-down	negative
malodorous	negative
expeditiously	positive
goof	negative
insupportable	negative
exorbitant	negative
misfit	negative
revolutionize	positive
suitable	positive
imaginary	negative
ached	negative
boggle	negative
detraction	negative
unorthodoxy	negative
shimmeringly	positive
betrays	negative
condescending	negative
annoyingly	negative
inundate	negative
plagiarize	negative
intoxicate	negative
dwindling	negative
winnable	positive
remission	positive
irresistible	positive
unconvincingly	negative
suavely	positive
wondrous	positive
pique	negative
remorseful	negative
recklessly	negative
ill-tempered	negative
doomsday	negative
shun	negative
craziness	negative
whimper	negative
opulent	positive
waning	negative
upsettingly	negative
revolutionizes	positive
drag	negative
difficulty	negative
survival	positive
roadblocks	negative
shrug	negative
confessions	negative
defective	negative
judders	negative
viciously	negative
dehumanize	negative
seamless	positive
madness	negative
meager	negative
lurid	negative
classy	positive
dungeon	negative
mischievous	negative
annoyance	negative
inimical	negative
poignant	positive
idiotically	negative
incorrectly	negative
garbage	negative
gratify	positive
unthinkable	negative
scandalized	negative
trivialize	negative
self-serving	negative
frustrate	negative
ingenuously	positive
soundness	positive
desolation	negative
spilling	negative
victimize	negative
benifits	positive
contravene	negative
villian	negative
womanizer	negative
immorally	negative
hotcakes	positive
bid-rigging	negative
inspire	positive
redundant	negative
gaining	positive
sucked	negative
sneeringly	negative
pitiable	negative
trusting	positive
sly	negative
fatty	negative
oversize	negative
admire	positive
tenderness	negative
eloquently	positive
unpopular	negative
explosive	negative
smitten	positive
suck	negative
antagonist	negative
relentless	negative
bemoaning	negative
anti-	negative
peacekeepers	positive
diatribe	negative
miss	negative
inadvisable	negative
unsatisfactory	negative
lech	negative
inhibition	negative
thicker	negative
lapsed	negative
triumphal	positive
ostracize	negative
rigidness	negative
bonny	positive
fascinatingly	positive
slap	negative
irate	negative
neurotically	negative
underestimate	negative
slog	negative
tyranny	negative
exasperation	negative
nitpick	negative
overbalance	negative
chintzy	negative
despoiler	negative
tyrant	negative
harassment	negative
bewail	negative
zapped	negative
slow	negative
astounded	positive
tantrum	negative
clouding	negative
ineloquent	negative
substandard	negative
bragger	negative
dastard	negative
anti-social	negative
drips	negative
selfish	negative
unsustainable	negative
argumentative	negative
bless	positive
huckster	negative
manipulators	negative
thrifty	positive
poverty	negative
scoldingly	negative
unsettlingly	negative
desecrate	negative
appal	negative
renewed	positive
objections	negative
interrupt	negative
glistening	positive
defeat	positive
nefariously	negative
touchy	negative
skeptical	negative
dick	negative
compassion	positive
death	negative
excitedness	positive
paupers	negative
credence	positive
allegations	negative
succeeded	positive
judder	negative
loathly	negative
elegant	positive
volatility	negative
discourage	negative
refusal	negative
unreasonably	negative
exuberant	positive
sour	negative
disapprobation	negative
slaves	negative
refuses	negative
thoughtfulness	positive
versatility	positive
uncomplicated	positive
irritations	negative
jeopardize	negative
indulge	negative
vouchsafe	positive
disprove	negative
strife	negative
amenable	positive
sprightly	positive
staid	negative
subsidized	positive
fictional	negative
denunciations	negative
rewardingly	positive
distorts	negative
impeccable	positive
topnotch	positive
interesting	positive
smiles	positive
mistake	negative
prettily	positive
extraordinarily	positive
regrets	negative
cave	negative
overthrows	negative
draining	negative
regressive	negative
diabolic	negative
gibberish	negative
hallmarks	positive
accomplishment	positive
trash	negative
dismay	negative
disdainfully	negative
inexpiable	negative
spectacularly	positive
get-rich	negative
phenomenal	positive
thrillingly	positive
cumbersome	negative
dissapointed	negative
litigious	negative
troublesome	negative
berate	negative
frictions	negative
hard-liner	negative
constructive	positive
zombie	negative
quarrellous	negative
deservedly	positive
unkindly	negative
insufferably	negative
accomplish	positive
humiliating	negative
vengeance	negative
proving	positive
appeal	positive
throttle	negative
positive	positive
elated	positive
indelicate	negative
figurehead	negative
controversy	negative
destroyer	negative
smilingly	positive
wholesome	positive
incomprehension	negative
overpower	negative
debility	negative
drippy	negative
exile	negative
difficult	negative
implausibly	negative
punctual	positive
afordable	positive
cheat	negative
slanders	negative
injustices	negative
anomaly	negative
disgustful	negative
denies	negative
veritable	positive
irretrievable	negative
fashionable	positive
retardedness	negative
quarrel	negative
agile	positive
disarm	negative
deplorably	negative
recoil	negative
repulsiveness	negative
unquestionable	positive
convenience	positive
thirst	negative
tumble	negative
sorrowful	negative
fruitlessly	negative
picturesque	positive
lush	positive
fastest-growing	positive
fanatics	negative
immaculate	positive
superior	positive
heroine	positive
deficient	negative
eventful	positive
grouch	negative
speedy	positive
malign	negative
wearisome	negative
stink	negative
riled	negative
disturbed	negative
negatives	negative
heresy	negative
important	positive
hacks	negative
disgruntle	negative
senseless	negative
rust	negative
dexterous	positive
clear	positive
skepticism	negative
quibble	negative
adventuresome	positive
discrimination	negative
reactionary	negative
incoherent	negative
disquietude	negative
troublesomely	negative
unhelpful	negative
ineloquently	negative
oppressively	negative
haughtily	negative
unscrupulously	negative
depressions	negative
competitive	positive
unable	negative
painlessly	positive
steadiness	positive
reasoned	positive
object	negative
bumpping	negative
snarl	negative
discontent	negative
pep	positive
flabbergast	negative
expired	negative
revival	positive
regretfully	negative
presumptuously	negative
smoulder	negative
rremediable	negative
awed	positive
energy-saving	positive
contradiction	negative
repulsive	negative
smudging	negative
cuplrit	negative
allegation	negative
imperiously	negative
oblique	negative
yawn	negative
suffers	negative
fleeting	negative
cold	negative
well-established	positive
moan	negative
bait	negative
relish	positive
overzealously	negative
unnerved	negative
steady	positive
dodgey	negative
dungeons	negative
traumatized	negative
disbelief	negative
well-positioned	positive
scratchy	negative
brutalising	negative
semi-retarded	negative
well-mannered	positive
impaired	negative
inappropriate	negative
puppets	negative
leer	negative
annihilation	negative
fecilitous	positive
overwhelmingly	negative
madden	negative
patriotic	positive
resent	negative
vomiting	negative
elegance	positive
vibrating	negative
heckle	negative
corrupts	negative
saintliness	positive
devilry	negative
extermination	negative
affordable	positive
fine	positive
conveniently	positive
franticly	negative
limitations	negative
virus	negative
destitute	negative
cajole	positive
taunts	negative
poorly	negative
sadly	negative
diversified	positive
deny	negative
glee	positive
marvels	positive
slowwww	negative
exceeding	positive
immense	positive
manageable	positive
favorite	positive
memorable	positive
despondency	negative
coupists	negative
mistakes	negative
achey	negative
affirm	positive
misrepresentation	negative
precipitate	negative
unaffected	positive
deceptively	negative
engulf	negative
undefined	negative
cliche	negative
needless	negative
denial	negative
ambitious	positive
lemon	negative
jutters	negative
erode	negative
improbability	negative
frigging	negative
thinner	positive
vibration	negative
rocky	negative
spew	negative
knowledgeable	positive
fallacy	negative
detestably	negative
powerful	positive
lapse	negative
inundated	negative
raped	negative
trap	negative
cancerous	negative
contortions	negative
covetous	negative
condemned	negative
snappish	negative
pandemonium	negative
meddle	negative
crushing	negative
martyrdom	negative
premier	positive
simplified	positive
tangled	negative
ruts	negative
trustworthy	positive
enthusiasm	positive
needy	negative
banish	negative
lied	negative
derisiveness	negative
perfectly	positive
broken-hearted	negative
wretchedness	negative
lamentable	negative
forceful	negative
joyous	positive
avalanche	negative
tension	negative
showdown	negative
ax	negative
peril	negative
flatteringly	positive
betraying	negative
lumpy	negative
sneakily	negative
loath	negative
unwilling	negative
gimmicks	negative
uncomfortable	negative
frenetic	negative
insidious	negative
excitement	positive
misuse	negative
damning	negative
eases	positive
indecorum	negative
satisfied	positive
throbbed	negative
indolent	negative
applaud	positive
grudge	negative
cushy	positive
worry	negative
appalled	negative
immaculately	positive
messing	negative
vindictively	negative
judicious	positive
tenacious	positive
striking	positive
zest	positive
vomit	negative
deject	negative
crippling	negative
strangest	negative
perplexing	negative
outrageously	negative
volatile	negative
downturns	negative
hysterics	negative
compliant	positive
truant	negative
disgustfully	negative
declines	negative
recklessness	negative
sucker	negative
shroud	negative
good	positive
slump	negative
deterioration	negative
chivalry	positive
rage	negative
dread	negative
detestable	negative
exhausts	negative
loveliness	positive
painfully	negative
tortured	negative
moron	negative
zaps	negative
pains	negative
stimulates	positive
uplift	positive
inviolable	positive
abrupt	negative
concede	negative
wonderously	positive
regreted	negative
stun	negative
titillate	positive
stupidity	negative
bulkyness	negative
drunken	negative
abused	negative
autocrat	negative
achievable	positive
hands-down	positive
jubilation	positive
pout	negative
questionable	negative
deride	negative
dislikes	negative
convient	positive
dexterously	positive
insensitive	negative
audaciousness	negative
respite	positive
garish	negative
offensively	negative
darkness	negative
staunch	positive
audacious	negative
boiling	negative
disliked	negative
ample	positive
trashed	negative
inconsequently	negative
revolutionary	positive
foolhardy	negative
spookily	negative
excel	positive
gratifyingly	positive
despise	negative
first-in-class	positive
frightening	negative
crap	negative
audibly	positive
fastidious	negative
cloud	negative
plight	negative
enviable	positive
flashy	positive
first-rate	positive
grievous	negative
bickering	negative
selective	positive
outperforms	positive
dangerous	negative
seething	negative
brash	negative
breathtaking	positive
privilege	positive
sophisticated	positive
ruffle	negative
invaluablely	positive
despondent	negative
self-determination	positive
gracious	positive
reckless	negative
handily	positive
restful	positive
dissolution	negative
favored	positive
nagging	negative
dumbfound	negative
delinquent	negative
timidness	negative
refused	negative
exciting	positive
imbroglio	negative
praising	positive
permissible	positive
bad	negative
rhetorical	negative
irreconcilable	negative
peeved	negative
short-lived	negative
misbehavior	negative
believeable	positive
incense	negative
fast-growing	positive
smelling	negative
rifts	negative
hectic	negative
conciliatory	positive
din	negative
irreproachable	positive
impeccably	positive
panicking	negative
punitive	negative
superficial	negative
understandable	positive
inexorably	negative
offensiveness	negative
lacks	negative
vagrant	negative
scoundrel	negative
blindingly	negative
lambaste	negative
flaw	negative
prominence	positive
erodes	negative
haunting	negative
adore	positive
monstrosity	negative
disunity	negative
laudably	positive
derision	negative
lionhearted	positive
reverent	positive
best-selling	positive
sinister	negative
excellency	positive
sugar-coated	negative
drunk	negative
ill-sorted	negative
uncomfortably	negative
dejectedly	negative
illicit	negative
issue	negative
commotion	negative
disaster	negative
love	positive
undependable	negative
lascivious	negative
non-violent	positive
dawdle	negative
extraordinary	positive
poor	negative
ecstatically	positive
mawkishly	negative
inaudible	negative
downfall	negative
foremost	positive
melancholy	negative
sensationally	positive
sloooow	negative
friggin	negative
abound	positive
amusingly	positive
ruining	negative
defender	positive
vibrant	positive
unease	negative
top-notch	positive
frightfully	negative
obscenely	negative
deceit	negative
futuristic	positive
bristle	negative
bull****	negative
backaching	negative
bloated	negative
puzzlement	negative
fearless	positive
mudslinger	negative
miserable	negative
drained	negative
snazzy	positive
spotless	positive
pandering	negative
cost-effective	positive
stumped	negative
blameworthy	negative
inconsistency	negative
dreadfulness	negative
crooks	negative
delightfulness	positive
hasseling	negative
wonders	positive
disinclination	negative
frazzle	negative
fell	negative
spookiest	negative
creeping	negative
fervor	positive
haters	negative
vomited	negative
standout	positive
smuttier	negative
satisfies	positive
prowess	positive
improbable	negative
obsessiveness	negative
light-hearted	positive
hallucination	negative
unsettle	negative
repudiate	negative
charisma	positive
murderous	negative
repel	negative
dependably	positive
abundant	positive
disinclined	negative
discourteously	negative
fickle	negative
tentative	negative
capable	positive
underpowered	negative
crippled	negative
bitterness	negative
merit	positive
enticed	positive
vice	negative
shame	negative
isolate	negative
trouble	negative
paranoid	negative
ruin	negative
skinny	negative
sink	negative
talent	positive
crack	negative
fabulously	positive
degradation	negative
toughness	negative
stunted	negative
woefully	negative
richly	positive
life-threatening	negative
negate	negative
intimidatingly	negative
tease	negative
bravado	negative
cripple	negative
unfaithfully	negative
deter	negative
incognizant	negative
entrap	negative
concerns	negative
gloomy	negative
peps	positive
tediously	negative
flaky	negative
anomalous	negative
inaction	negative
incompatibility	negative
rectifying	positive
die-hard	negative
kudos	positive
valuable	positive
faults	negative
benefit	positive
glory	positive
wound	negative
oppressive	negative
infuriating	negative
right	positive
underpaid	negative
prejudice	negative
gloriously	positive
molestation	negative
odd	negative
heartfelt	positive
troubles	negative
incomparably	negative
humorous	positive
promoter	positive
helpless	negative
gained	positive
reprehensibly	negative
inconsequent	negative
infraction	negative
heartily	positive
exalting	positive
despotism	negative
lawbreaker	negative
delicacy	positive
conceded	negative
yay	positive
altruistically	positive
degenerately	negative
scoffingly	negative
ailment	negative
brutish	negative
terrible	negative
unsecure	negative
eagerness	positive
panders	negative
slanderous	negative
quandary	negative
twisted	negative
fame	positive
divergent	negative
obscures	negative
neurotic	negative
stubborn	negative
sufferers	negative
divisively	negative
belie	negative
punish	negative
randomly	negative
paralize	negative
disdained	negative
infringe	negative
tarnished	negative
undetermined	negative
repress	negative
cleanly	positive
madman	negative
niggles	negative
worse	negative
superbly	positive
backbite	negative
hard	negative
uncooperative	negative
excelent	positive
indeterminably	negative
corrosion	negative
smuttiest	negative
sedentary	negative
shunned	negative
crisis	negative
die	negative
failures	negative
deceitful	negative
mismanage	negative
grudging	negative
luckier	positive
loves	positive
seedy	negative
exalted	positive
prosecute	negative
taut	negative
lier	negative
disgusted	negative
struggles	negative
careless	negative
solace	positive
dynamic	positive
complicit	negative
blurred	negative
poise	positive
